Año;Mes;Región;Cultivo;Superficie_Ha;Producción_Ton;Precio_Ton;Costos_Insumos;Ingresos;Utilidad
2023;7;Sur;Manzana;34;4583;378;5267;1730770;1725503
2024;5;Centro;Tomate;253;3501;106;6988;372681;365693
2023;3;Sur;Soja;430;716;249;9680;178327;168647
2023;3;Sur;Soja;37;3074;241;2485;739850;737365
2023;4;Norte;Maíz;462;763;317;15713;242169;226456
2024;12;Sur;Trigo;233;597;129;3419;77067;73648
2023;2;Sur;Tomate;16;1344;416;16312;559171;542859
2023;2;Centro;Uva;122;1857;187;4495;347463;342968
2023;1;Norte;Soja;354;3944;371;18140;1462514;1444374
2024;5;Norte;Soja;159;3936;421;11716;1658158;1646442
2023;4;Norte;Tomate;427;3327;325;13442;1080443;1067001
2023;11;Sur;Manzana;397;4030;396;19163;1597291;1578128
2023;10;Norte;Manzana;250;3165;365;13961;1154402;1140441
2023;2;Sur;Trigo;409;4312;242;11307;1044410;1033103
2024;3;Sur;Maíz;336;2208;424;7487;935176;927689
2023;7;Centro;Soja;251;174;218;10664;37911;27247
2024;7;Centro;Maíz;33;2008;328;17360;659608;642248
2024;12;Centro;Manzana;165;3067;398;17642;1221157;1203515
2024;4;Centro;Manzana;239;2094;252;5075;526809;521734
2023;5;Centro;Papa;194;4438;221;18502;981286;962784
2024;5;Sur;Uva;121;412;284;16285;116901;100616
2023;6;Sur;Trigo;275;423;427;8631;180701;172070
2024;9;Norte;Papa;262;54;472;4017;25486;21469
2024;2;Sur;Uva;184;4167;318;19042;1325231;1306189
2024;5;Sur;Papa;491;2477;365;19181;903089;883908
2024;12;Centro;Papa;377;877;461;1784;404569;402785
2024;3;Sur;Trigo;176;28;139;6691;3904;-2787
2024;4;Centro;Trigo;442;374;193;16765;72118;55353
2024;10;Norte;Tomate;278;3842;384;4196;1473638;1469442
2024;6;Norte;Maíz;263;589;430;10552;252976;242424
2023;12;Sur;Maíz;139;555;443;9532;245760;236228
2023;8;Norte;Tomate;175;4160;266;17946;1106726;1088780
2024;1;Sur;Tomate;214;4883;136;5746;662818;657072
2024;10;Norte;Manzana;240;3049;275;3999;838810;834811
2024;8;Centro;Uva;426;4147;192;18577;797427;778850
2023;11;Centro;Papa;425;4054;216;12302;877610;865308
2024;7;Centro;Tomate;190;4336;409;17452;1773034;1755582
2023;1;Centro;Soja;421;462;130;16595;60157;43562
2023;2;Sur;Maíz;368;3971;431;19812;1711620;1691808
2023;3;Norte;Tomate;447;1391;271;7200;377058;369858
2023;1;Sur;Soja;99;1477;338;6396;499861;493465
2023;9;Centro;Soja;382;2748;136;14410;373343;358933
2024;8;Sur;Soja;15;1226;235;14203;288036;273833
2024;2;Norte;Manzana;72;890;136;4598;120933;116335
2024;9;Sur;Manzana;383;3824;485;11564;1853187;1841623
2024;7;Norte;Soja;214;3159;423;13748;1335941;1322193
2024;9;Sur;Uva;200;94;284;17957;26682;8725
2023;6;Norte;Manzana;373;4154;189;8636;786934;778298
2024;6;Norte;Papa;102;1178;473;18862;557642;538780
2024;11;Centro;Soja;97;4174;238;11265;992744;981479
2023;4;Norte;Papa;476;3139;164;10705;516020;505315
2024;10;Centro;Papa;26;3655;325;15298;1188862;1173564
2023;10;Centro;Soja;454;2536;478;19580;1210965;1191385
2024;2;Centro;Maíz;176;2877;102;10703;292102;281399
2023;7;Sur;Uva;387;3526;195;14336;688452;674116
2024;5;Sur;Soja;138;3377;475;9166;1605358;1596192
2024;11;Sur;Soja;430;2204;168;17116;371220;354104
2023;6;Sur;Manzana;29;3565;145;7050;517995;510945
2023;2;Norte;Soja;189;455;328;12184;149272;137088
2023;5;Norte;Maíz;89;3636;445;13712;1617075;1603363
2023;10;Sur;Manzana;59;4026;291;9484;1170922;1161438
2023;4;Norte;Trigo;255;3885;498;3593;1934070;1930477
2023;9;Norte;Trigo;148;3347;372;11315;1243979;1232664
2023;6;Centro;Papa;355;271;130;16200;35130;18930
2023;2;Centro;Uva;402;1858;497;10107;923668;913561
2024;1;Centro;Papa;171;4035;263;4869;1061851;1056982
2024;5;Centro;Maíz;416;2276;215;16447;489249;472802
2023;9;Norte;Tomate;228;101;323;8971;32638;23667
2024;6;Sur;Uva;224;4232;222;3989;938319;934330
2024;10;Norte;Trigo;183;4185;135;6340;563217;556877
2024;12;Norte;Papa;123;3319;101;10643;333792;323149
2024;7;Norte;Trigo;437;992;280;4823;277591;272768
2023;5;Centro;Maíz;269;3453;435;14454;1501192;1486738
2024;10;Centro;Maíz;446;2543;329;4932;836469;831537
2023;6;Centro;Tomate;433;703;500;11220;351275;340055
2024;5;Sur;Tomate;154;4130;215;9554;886876;877322
2024;11;Norte;Manzana;420;165;212;3429;35010;31581
2024;9;Sur;Uva;457;3598;164;8444;589712;581268
2023;6;Centro;Maíz;219;1822;166;11510;301778;290268
2024;11;Sur;Papa;201;4124;214;12277;882825;870548
2023;8;Norte;Trigo;46;1417;417;11537;591087;579550
2024;2;Norte;Soja;57;1226;462;8147;566780;558633
2023;12;Centro;Tomate;484;1420;490;8631;695843;687212
2024;9;Centro;Soja;447;3507;193;4598;676570;671972
2023;5;Sur;Papa;334;4382;453;5329;1982943;1977614
2023;7;Centro;Tomate;255;4850;231;7718;1121805;1114087
2024;10;Centro;Soja;299;561;145;10923;81424;70501
2023;1;Norte;Uva;382;3404;448;14782;1525026;1510244
2024;10;Centro;Papa;275;1186;354;17476;420366;402890
2024;5;Centro;Trigo;459;4744;166;1051;786982;785931
2024;12;Norte;Uva;417;4342;272;17702;1180720;1163018
2024;10;Norte;Papa;127;1007;215;11184;216404;205220
2024;2;Sur;Manzana;371;4086;395;13468;1612826;1599358
2024;12;Centro;Tomate;391;2741;281;16479;771235;754756
2024;6;Norte;Maíz;343;3947;496;8210;1956567;1948357
2024;11;Sur;Trigo;270;4062;122;13934;495158;481224
2024;1;Sur;Uva;352;382;242;4956;92448;87492
2024;3;Centro;Uva;33;2258;293;7057;661052;653995
2024;5;Centro;Soja;467;858;301;12210;258473;246263
2023;4;Sur;Tomate;39;2566;226;15590;580865;565275
2023;3;Norte;Maíz;10;2332;392;14864;913444;898580
2024;10;Sur;Papa;400;513;450;2525;230799;228274
2024;5;Centro;Maíz;115;3199;475;14277;1521093;1506816
2024;11;Norte;Tomate;298;712;422;8043;300492;292449
2024;8;Norte;Tomate;81;3635;440;18662;1600236;1581574
2024;11;Sur;Manzana;353;324;320;9705;103751;94046
2024;4;Centro;Manzana;151;2386;430;7125;1026839;1019714
2024;1;Sur;Maíz;71;1050;221;8874;232470;223596
2024;11;Sur;Papa;396;4388;259;13529;1138203;1124674
2023;7;Sur;Maíz;12;3000;227;15955;680310;664355
2024;8;Norte;Tomate;126;267;287;3500;76616;73116
2023;3;Norte;Tomate;344;584;214;4464;125110;120646
2024;6;Centro;Soja;179;4679;485;19643;2267631;2247988
2024;2;Centro;Manzana;392;1562;225;16954;351669;334715
2023;7;Sur;Soja;183;4528;139;1255;630388;629133
2024;8;Sur;Trigo;89;767;311;2502;238330;235828
2023;6;Sur;Tomate;455;2820;123;5656;346409;340753
2024;6;Centro;Soja;49;1114;144;11302;160661;149359
2024;5;Norte;Maíz;140;4534;188;6430;851304;844874
2023;8;Norte;Manzana;347;3469;286;9598;991232;981634
2024;1;Sur;Manzana;20;4002;273;16976;1093747;1076771
2023;10;Sur;Papa;337;213;420;2860;89434;86574
2024;4;Sur;Maíz;199;2785;396;7158;1102275;1095117
2023;4;Sur;Papa;13;2342;271;6806;633581;626775
2023;3;Centro;Soja;320;2002;233;18106;467427;449321
2024;3;Norte;Uva;338;2253;227;10474;510507;500033
2024;4;Sur;Trigo;337;316;410;17997;129434;111437
2023;11;Centro;Maíz;331;1697;121;6790;205049;198259
2024;1;Sur;Maíz;19;4119;105;11170;433030;421860
2024;11;Sur;Maíz;331;1870;418;10004;782071;772067
2024;11;Norte;Papa;106;1971;291;10978;573285;562307
2023;2;Sur;Soja;230;732;152;17714;111520;93806
2023;9;Norte;Maíz;429;789;194;19596;153247;133651
2023;10;Norte;Uva;282;538;473;8232;254474;246242
2023;2;Norte;Maíz;412;4903;444;13674;2175951;2162277
2023;5;Centro;Manzana;117;353;384;17052;135520;118468
2023;9;Centro;Trigo;489;3796;293;16774;1111810;1095036
2023;9;Norte;Manzana;432;3692;308;6913;1137616;1130703
2023;8;Sur;Manzana;5;218;490;15102;106842;91740
2023;1;Norte;Trigo;270;4746;486;16389;2308027;2291638
2024;1;Sur;Uva;495;3416;186;11567;635752;624185
2023;9;Norte;Soja;212;1321;424;6611;560685;554074
2024;11;Sur;Manzana;114;2309;179;10432;413080;402648
2024;8;Centro;Soja;204;3346;185;1319;620382;619063
2024;10;Sur;Manzana;444;1957;370;13686;724951;711265
2023;9;Norte;Tomate;373;929;262;5791;243398;237607
2023;7;Centro;Trigo;477;2054;473;1329;970761;969432
2023;3;Sur;Manzana;310;428;136;9851;58037;48186
2023;3;Sur;Tomate;16;1759;305;12310;535809;523499
2024;2;Sur;Papa;349;2852;467;11164;1333053;1321889
2023;5;Sur;Tomate;469;1109;462;19177;511970;492793
2023;12;Sur;Maíz;192;3402;163;6703;553199;546496
2023;12;Centro;Manzana;158;2782;247;11649;686208;674559
2023;3;Centro;Tomate;498;2490;348;13672;865649;851977
2023;6;Centro;Soja;372;1555;164;5155;254647;249492
2024;2;Centro;Papa;338;1080;487;3611;526187;522576
2023;12;Norte;Uva;429;1860;466;19977;866574;846597
2024;3;Centro;Manzana;424;4208;167;17479;701810;684331
2023;5;Sur;Maíz;381;2949;148;10180;437809;427629
2024;12;Sur;Uva;283;1913;134;10304;256648;246344
2023;11;Centro;Tomate;175;688;464;15610;319081;303471
2023;11;Sur;Uva;138;998;177;9437;177095;167658
2024;1;Centro;Uva;499;2485;267;11350;662277;650927
2024;1;Sur;Papa;457;1617;280;13521;452016;438495
2024;10;Norte;Uva;431;2879;340;7560;977708;970148
2023;9;Norte;Uva;29;1512;129;6247;194579;188332
2024;7;Centro;Manzana;22;1799;191;5077;343069;337992
2023;1;Centro;Papa;194;1435;473;11858;678181;666323
2023;12;Centro;Maíz;145;2450;463;12391;1135232;1122841
2024;8;Sur;Tomate;47;2052;413;11946;846491;834545
2024;3;Centro;Papa;338;1288;108;16186;138795;122609
2023;8;Norte;Papa;288;2604;231;2417;601003;598586
2023;5;Sur;Trigo;150;4699;351;17494;1650195;1632701
2024;1;Centro;Papa;319;2446;210;9954;513856;503902
2024;7;Sur;Trigo;448;3813;464;14591;1768584;1753993
2024;5;Sur;Tomate;323;2215;354;8391;783135;774744
2023;6;Centro;Uva;445;1037;129;12364;133524;121160
2023;6;Sur;Manzana;96;3549;464;11371;1645316;1633945
2023;8;Norte;Manzana;183;3493;483;3504;1687503;1683999
2023;9;Norte;Tomate;60;2251;131;6239;295061;288822
2023;2;Sur;Tomate;159;2775;313;17676;868409;850733
2023;9;Centro;Soja;164;1183;221;19118;261857;242739
2024;12;Sur;Uva;115;3240;257;6120;833134;827014
2023;11;Norte;Tomate;141;3360;172;7393;577450;570057
2023;10;Sur;Papa;236;4921;331;3196;1629983;1626787
2023;9;Sur;Manzana;484;413;483;4466;199557;195091
2024;10;Norte;Maíz;472;4998;301;2906;1505548;1502642
2023;10;Sur;Manzana;224;2735;133;19105;364220;345115
2023;7;Sur;Trigo;485;3392;348;12883;1180416;1167533
2024;1;Centro;Manzana;72;4173;236;16437;985204;968767
2023;7;Centro;Soja;306;97;442;15497;42910;27413
2023;10;Norte;Uva;253;1168;274;2816;319880;317064
2023;5;Norte;Tomate;486;4283;177;11713;758691;746978
2023;6;Norte;Uva;327;2867;176;4849;505853;501004
2023;10;Centro;Tomate;414;1391;408;7849;566846;558997
2024;7;Norte;Manzana;396;4691;206;2058;967472;965414
2024;5;Norte;Maíz;10;2074;407;12730;843890;831160
2024;7;Norte;Maíz;468;2384;182;19706;434722;415016
2023;9;Centro;Soja;284;327;229;18332;74775;56443
2023;3;Sur;Trigo;436;1512;286;5359;432719;427360
2023;8;Norte;Manzana;491;2052;477;13809;979379;965570
2024;2;Sur;Tomate;98;4608;473;6660;2178156;2171496
2023;11;Norte;Manzana;433;2032;183;8254;371348;363094
2023;7;Sur;Soja;273;128;243;13822;31141;17319
2024;2;Centro;Papa;201;719;160;3093;114867;111774
2023;4;Centro;Papa;29;3567;304;12730;1084332;1071602
2024;7;Norte;Soja;152;4150;284;18947;1179555;1160608
2024;3;Sur;Tomate;122;4419;460;9217;2034066;2024849
2024;2;Centro;Uva;342;3260;472;17558;1538720;1521162
2023;11;Norte;Soja;371;427;253;18718;108215;89497
2023;10;Norte;Tomate;342;2613;297;17705;775277;757572
2023;7;Centro;Maíz;70;3864;458;13342;1771605;1758263
2023;1;Centro;Soja;462;1111;423;13239;469597;456358
2023;8;Norte;Tomate;305;4431;101;14854;449569;434715
2023;3;Sur;Soja;374;3438;228;14897;783933;769036
2023;12;Sur;Soja;179;2271;269;12419;610240;597821
2024;12;Sur;Uva;323;4179;192;11064;801908;790844
2023;2;Norte;Uva;80;3644;180;16003;655301;639298
2024;3;Centro;Tomate;499;518;115;11259;59627;48368
2023;5;Norte;Tomate;465;2389;357;6674;853709;847035
2023;11;Centro;Trigo;118;3174;205;6002;650670;644668
2023;8;Sur;Soja;115;697;121;1910;84295;82385
2024;10;Sur;Papa;253;4762;192;1949;916161;914212
2024;7;Centro;Soja;443;1302;421;19898;547843;527945
2024;7;Centro;Soja;207;3915;441;12523;1724949;1712426
2024;12;Norte;Tomate;151;3085;293;12221;904615;892394
2023;7;Sur;Soja;39;3219;266;17484;857638;840154
2024;8;Norte;Manzana;491;334;491;5646;164041;158395
2023;1;Norte;Soja;313;2003;180;7945;361001;353056
2023;4;Norte;Manzana;30;3986;186;3400;741954;738554
2024;6;Sur;Uva;242;4822;217;12563;1045169;1032606
2024;9;Norte;Papa;18;2780;169;19727;470098;450371
2024;2;Norte;Tomate;378;4382;252;1352;1103169;1101817
2024;1;Norte;Soja;49;2593;464;16489;1204008;1187519
2024;10;Norte;Manzana;432;3567;346;2018;1234681;1232663
2024;12;Norte;Manzana;220;3597;265;18563;952414;933851
2024;2;Norte;Uva;237;161;474;6193;76275;70082
2024;7;Sur;Manzana;197;964;119;16701;115092;98391
2023;3;Norte;Maíz;55;4364;184;4536;803456;798920
2024;10;Centro;Trigo;431;2381;326;16449;777063;760614
2024;2;Norte;Papa;379;4974;346;12842;1722098;1709256
2023;11;Norte;Uva;218;1201;116;19886;139100;119214
2024;7;Sur;Uva;155;697;261;4819;182070;177251
2023;2;Sur;Soja;444;319;360;18363;114732;96369
2023;3;Centro;Maíz;279;1512;379;1976;573396;571420
2024;11;Centro;Soja;342;3137;355;19664;1114451;1094787
2023;7;Sur;Soja;80;4578;228;6897;1044837;1037940
2023;4;Sur;Tomate;443;3377;137;16957;464034;447077
2023;1;Norte;Tomate;224;3405;271;16359;922210;905851
2023;5;Sur;Tomate;352;823;152;14240;124685;110445
2024;12;Centro;Maíz;448;855;479;1107;409588;408481
2023;9;Norte;Soja;191;1174;290;16524;340542;324018
2024;8;Centro;Trigo;293;4772;227;2626;1082767;1080141
2023;12;Norte;Papa;407;1777;407;7229;722386;715157
2023;9;Sur;Tomate;32;364;299;7877;108902;101025
2023;10;Centro;Tomate;383;1882;224;1874;421587;419713
2023;9;Norte;Uva;184;2034;425;6543;864023;857480
2024;7;Norte;Soja;257;2827;447;4809;1263273;1258464
2024;4;Sur;Soja;130;3842;369;11603;1418466;1406863
2023;5;Sur;Maíz;181;4285;119;3107;509015;505908
2023;1;Sur;Maíz;41;75;327;12745;24490;11745
2024;1;Centro;Tomate;414;4925;405;10465;1996201;1985736
2023;3;Norte;Soja;103;4276;155;1559;661070;659511
2023;8;Sur;Trigo;102;4100;191;9308;785027;775719
2023;2;Centro;Papa;131;2531;453;16250;1146543;1130293
2024;4;Centro;Soja;487;2591;108;14255;279958;265703
2024;2;Centro;Uva;172;1400;401;4046;561526;557480
2024;5;Sur;Soja;84;1140;290;14856;330041;315185
2023;9;Sur;Manzana;298;2496;279;17427;695660;678233
2023;1;Norte;Maíz;337;844;103;1508;86797;85289
2024;5;Norte;Uva;130;236;428;7107;100951;93844
2024;9;Sur;Papa;347;3525;244;14476;859853;845377
2024;1;Centro;Tomate;314;4547;316;4439;1438262;1433823
2024;9;Centro;Uva;154;2453;371;14136;909867;895731
2023;8;Centro;Soja;20;737;381;15167;280834;265667
2024;4;Norte;Tomate;32;3696;482;18300;1782913;1764613
2023;12;Centro;Soja;423;3632;313;18182;1135145;1116963
2024;11;Norte;Tomate;448;1046;260;5971;271845;265874
2023;10;Norte;Papa;177;1842;481;19144;886886;867742
2024;5;Centro;Maíz;50;2750;357;16883;981310;964427
2024;5;Centro;Papa;332;502;219;1818;110069;108251
2024;11;Sur;Manzana;240;1558;151;11360;234619;223259
2024;12;Sur;Trigo;443;1153;437;12927;503884;490957
2023;6;Centro;Maíz;218;3967;245;17023;971399;954376
2024;7;Norte;Papa;89;3417;364;4065;1244437;1240372
2023;8;Norte;Manzana;286;649;288;4259;187126;182867
2023;8;Norte;Trigo;236;182;180;18290;32682;14392
2023;11;Norte;Manzana;89;4364;341;13300;1486684;1473384
2023;2;Norte;Soja;413;3969;124;1602;493228;491626
2024;9;Sur;Soja;493;526;265;5295;139569;134274
2023;7;Centro;Tomate;69;532;319;10983;169522;158539
2023;4;Sur;Maíz;138;1927;274;4527;528807;524280
2023;4;Norte;Soja;155;2896;399;2811;1156865;1154054
2024;11;Norte;Uva;119;2174;431;13103;937364;924261
2024;8;Norte;Manzana;68;1939;409;10032;792082;782050
2024;4;Norte;Maíz;347;3955;116;13877;456921;443044
2024;6;Centro;Uva;431;2219;178;8963;394205;385242
2023;5;Norte;Soja;367;3793;315;16224;1193430;1177206
2023;3;Centro;Tomate;411;2600;474;9916;1232218;1222302
2024;10;Norte;Papa;356;4944;434;7766;2145597;2137831
2023;11;Centro;Tomate;162;4086;437;18186;1785623;1767437
2023;2;Sur;Uva;81;1103;221;19966;244072;224106
2023;9;Norte;Trigo;495;3890;272;2665;1057224;1054559
2024;10;Centro;Soja;150;2504;288;16932;721853;704921
2024;9;Sur;Uva;347;2589;163;7975;421878;413903
2023;1;Norte;Trigo;467;2498;112;3552;280850;277298
2024;10;Norte;Trigo;229;2795;479;14219;1338134;1323915
2024;3;Norte;Manzana;409;2768;196;15274;543331;528057
2024;8;Centro;Maíz;317;1584;196;13612;310432;296820
2024;6;Centro;Manzana;107;2383;133;3808;317773;313965
2024;5;Sur;Soja;411;4000;471;12090;1885600;1873510
2023;5;Centro;Trigo;351;4855;332;13260;1611326;1598066
2024;6;Centro;Uva;305;1103;367;16295;404591;388296
2023;7;Norte;Papa;432;1199;465;15837;557091;541254
2023;1;Norte;Trigo;470;2699;238;15669;643037;627368
2024;9;Norte;Uva;92;4105;349;11523;1431003;1419480
2023;3;Norte;Papa;375;1885;116;13762;217755;203993
2023;4;Norte;Manzana;307;3416;175;14769;596809;582040
2023;10;Norte;Manzana;172;1797;433;14731;777203;762472
2024;1;Norte;Maíz;439;3942;407;12877;1603251;1590374
2024;11;Sur;Uva;174;1617;240;3456;388500;385044
2023;10;Sur;Trigo;139;3758;251;6423;942206;935783
2024;3;Sur;Tomate;54;58;313;15246;18178;2932
2024;2;Sur;Manzana;436;3871;100;13846;387487;373641
2024;2;Norte;Manzana;344;2190;197;5317;430335;425018
2024;1;Sur;Maíz;351;3056;183;18940;560134;541194
2023;8;Norte;Papa;138;2843;200;19589;569140;549551
2023;3;Sur;Maíz;351;1407;422;13635;594261;580626
2024;3;Centro;Trigo;141;3836;212;14470;812733;798263
2024;6;Sur;Uva;249;4584;177;14176;809580;795404
2023;8;Sur;Soja;113;841;302;10113;253738;243625
2023;9;Norte;Soja;317;2707;446;14546;1208026;1193480
2024;9;Sur;Uva;291;4787;197;7805;940837;933032
2023;4;Centro;Papa;25;2745;131;17788;360720;342932
2024;5;Norte;Manzana;94;91;243;19004;22073;3069
2024;2;Norte;Papa;300;96;399;9080;38310;29230
2023;11;Sur;Manzana;116;2073;320;4118;663940;659822
2023;9;Norte;Manzana;305;831;427;7630;354604;346974
2024;8;Norte;Soja;81;172;484;1565;83220;81655
2024;3;Norte;Papa;181;3749;417;16701;1563558;1546857
2023;11;Norte;Maíz;347;2407;342;15859;822039;806180
2024;12;Norte;Manzana;152;1942;297;8670;577434;568764
2023;9;Norte;Tomate;105;2738;116;10476;317690;307214
2024;3;Centro;Tomate;250;3545;494;9776;1750273;1740497
2023;9;Sur;Maíz;121;3456;253;16021;875716;859695
2023;2;Centro;Tomate;96;2800;161;5327;450492;445165
2023;12;Norte;Trigo;405;2717;367;16275;996270;979995
2024;10;Norte;Manzana;32;3943;214;8614;842698;834084
2024;9;Sur;Maíz;429;3395;334;2245;1134982;1132737
2023;8;Centro;Papa;454;932;335;9243;311950;302707
2024;9;Sur;Manzana;29;2185;278;11355;608064;596709
2023;5;Centro;Maíz;62;1592;434;1537;691644;690107
2023;11;Norte;Soja;301;574;206;16924;118238;101314
2024;11;Sur;Papa;138;3268;279;17236;913243;896007
2024;2;Sur;Soja;335;2607;315;17924;821414;803490
2023;8;Norte;Manzana;253;2510;365;18198;917280;899082
2024;12;Sur;Papa;42;4576;414;2415;1892588;1890173
2024;6;Centro;Tomate;394;997;258;12030;257146;245116
2023;8;Centro;Maíz;433;3646;358;2652;1306799;1304147
2023;11;Centro;Manzana;79;233;160;11857;37336;25479
2024;5;Centro;Trigo;146;360;473;19740;170302;150562
2023;10;Norte;Papa;326;1938;253;4810;490740;485930
2023;2;Sur;Papa;172;358;392;17569;140268;122699
2024;6;Centro;Uva;263;4287;108;2551;463596;461045
2023;5;Norte;Manzana;377;4742;182;14584;863376;848792
2023;12;Sur;Manzana;359;1027;295;1761;302790;301029
2024;12;Sur;Soja;229;2236;451;13511;1009107;995596
2024;5;Norte;Uva;156;4877;311;10471;1516259;1505788
2023;1;Norte;Tomate;23;4134;472;13467;1951041;1937574
2023;2;Centro;Soja;150;2429;294;7163;712960;705797
2024;8;Sur;Uva;452;1903;296;17065;563631;546566
2024;3;Sur;Soja;245;3050;148;12886;451095;438209
2024;10;Norte;Tomate;376;2078;421;18920;874963;856043
2024;3;Sur;Uva;385;1135;199;7201;225627;218426
2023;8;Centro;Uva;348;3127;460;16580;1437920;1421340
2024;8;Sur;Trigo;241;4171;464;8399;1936720;1928321
2024;2;Norte;Soja;39;4052;477;17945;1934101;1916156
2023;8;Norte;Soja;194;4443;308;8623;1368844;1360221
2024;11;Centro;Papa;5;2180;371;11327;808431;797104
2023;1;Centro;Tomate;488;456;411;8187;187603;179416
2024;6;Sur;Maíz;157;2668;152;3180;406630;403450
2024;8;Sur;Trigo;433;3372;340;2960;1147761;1144801
2024;3;Norte;Uva;437;2728;114;6153;310228;304075
2023;8;Centro;Uva;130;3493;299;8035;1044512;1036477
2023;12;Centro;Uva;495;2954;162;12471;478371;465900
2024;1;Centro;Trigo;486;4386;173;1582;759524;757942
2023;11;Sur;Uva;349;605;246;16514;148842;132328
2023;11;Centro;Uva;404;1996;273;16531;544848;528317
2023;9;Norte;Tomate;230;2760;349;17672;963985;946313
2023;11;Norte;Manzana;225;1084;130;8979;140671;131692
2023;9;Sur;Manzana;407;3979;301;4060;1199589;1195529
2023;5;Sur;Papa;411;4315;173;14731;746711;731980
2024;10;Centro;Papa;215;4231;330;13294;1394495;1381201
2024;4;Sur;Uva;29;4597;355;18567;1631751;1613184
2023;11;Norte;Tomate;20;3590;323;15274;1158421;1143147
2024;6;Centro;Uva;186;3017;395;18830;1192680;1173850
2024;12;Norte;Papa;333;979;234;17348;229321;211973
2024;7;Centro;Trigo;133;590;406;2903;239564;236661
2024;5;Sur;Trigo;46;2834;273;15551;773994;758443
2023;11;Centro;Maíz;407;4011;294;16141;1177910;1161769
2024;10;Centro;Manzana;485;1221;359;3377;438632;435255
2024;9;Norte;Tomate;422;239;107;1847;25654;23807
2023;3;Norte;Soja;340;4294;362;15380;1552710;1537330
2023;7;Centro;Manzana;240;3195;347;18623;1110039;1091416
2024;10;Sur;Soja;364;511;224;10524;114433;103909
2024;10;Sur;Maíz;443;2142;134;16231;287713;271482
2024;11;Norte;Maíz;406;58;136;12698;7909;-4789
2024;5;Sur;Uva;38;3576;469;11571;1678181;1666610
2024;7;Norte;Papa;349;3065;376;13314;1151551;1138237
2024;2;Sur;Maíz;385;698;151;12429;105286;92857
2023;4;Centro;Maíz;49;396;243;3365;96105;92740
2024;2;Norte;Soja;138;979;337;11604;329913;318309
2024;12;Norte;Papa;25;3470;434;12366;1506778;1494412
2023;7;Centro;Maíz;126;1015;117;6055;119222;113167
2023;2;Norte;Manzana;74;3062;195;6622;596018;589396
2023;11;Sur;Maíz;356;3427;456;17756;1562369;1544613
2023;1;Sur;Papa;365;2312;104;8783;239685;230902
2024;9;Norte;Uva;52;2293;181;2949;414024;411075
2024;1;Sur;Tomate;495;1617;484;17628;781997;764369
2024;8;Norte;Papa;43;4376;345;11032;1511295;1500263
2024;2;Centro;Soja;291;132;205;12619;27016;14397
2024;12;Norte;Tomate;494;1290;127;17508;163572;146064
2024;8;Centro;Manzana;14;3737;111;13824;415853;402029
2023;3;Sur;Trigo;34;268;198;11945;53037;41092
2024;6;Centro;Papa;248;957;453;2919;433129;430210
2023;3;Sur;Uva;278;4968;266;10827;1323326;1312499
2023;7;Norte;Soja;448;534;388;10617;207261;196644
2024;10;Sur;Manzana;92;897;467;10732;419177;408445
2023;9;Norte;Tomate;248;217;263;1530;57119;55589
2024;2;Norte;Manzana;385;3392;177;8849;598722;589873
2023;12;Centro;Papa;333;2804;307;7929;860407;852478
2024;12;Centro;Maíz;483;158;463;5349;73190;67841
2023;5;Centro;Uva;19;447;422;15456;188522;173066
2024;6;Centro;Papa;8;2212;126;12295;279442;267147
2024;4;Sur;Trigo;195;3759;377;19185;1417256;1398071
2024;4;Sur;Papa;172;3171;329;6156;1042498;1036342
2024;4;Sur;Tomate;13;3911;463;10228;1810754;1800526
2024;2;Norte;Tomate;113;4463;149;12920;664942;652022
2023;4;Sur;Papa;141;3255;314;8432;1020801;1012369
2023;11;Sur;Tomate;158;4561;452;13203;2060614;2047411
2023;1;Sur;Maíz;392;2833;264;7189;747940;740751
2024;12;Centro;Manzana;213;4734;293;2142;1386115;1383973
2023;6;Sur;Papa;276;3280;128;8614;420430;411816
2024;1;Norte;Uva;147;495;211;15253;104574;89321
2024;10;Centro;Maíz;103;209;230;19013;48028;29015
2023;6;Norte;Manzana;381;4476;478;18146;2139752;2121606
2023;1;Sur;Uva;312;1992;213;7905;424435;416530
2024;6;Centro;Uva;73;1481;284;5889;421122;415233
2023;10;Norte;Uva;251;4353;369;5839;1604168;1598329
2024;8;Sur;Manzana;265;4893;165;4957;806709;801752
2024;11;Norte;Maíz;280;2321;295;1557;683720;682163
2024;2;Norte;Uva;83;3383;395;5621;1337706;1332085
2024;2;Norte;Uva;150;2088;447;15932;932793;916861
2024;12;Sur;Soja;115;1531;351;1839;536616;534777
2023;4;Sur;Papa;262;614;368;10243;225719;215476
2023;11;Norte;Manzana;97;3858;151;10596;580668;570072
2024;3;Centro;Manzana;17;3352;478;7998;1603295;1595297
2024;4;Centro;Tomate;264;1427;153;11129;218374;207245
2023;12;Sur;Manzana;430;4607;410;1510;1888271;1886761
2023;7;Sur;Maíz;113;3885;206;12596;800038;787442
2024;11;Sur;Manzana;334;2943;473;13974;1393334;1379360
2023;1;Sur;Soja;193;558;388;2137;216493;214356
2024;6;Sur;Papa;99;848;402;14700;340497;325797
2023;3;Centro;Papa;109;3825;188;5666;717647;711981
2024;11;Sur;Manzana;12;857;277;9906;237578;227672
2023;10;Norte;Uva;71;4719;347;11478;1638106;1626628
2024;7;Norte;Trigo;195;4517;408;3654;1842891;1839237
2023;10;Centro;Trigo;370;4783;142;1990;677177;675187
2023;2;Norte;Uva;260;4264;485;3160;2067827;2064667
2024;2;Centro;Uva;13;4478;456;16136;2042371;2026235
2023;4;Centro;Uva;482;2282;208;11336;474975;463639
2024;1;Norte;Maíz;121;3330;429;15269;1428903;1413634
2023;3;Sur;Trigo;271;2568;307;17206;789223;772017
2024;9;Norte;Uva;103;4708;285;3063;1340462;1337399
2023;7;Norte;Maíz;489;4321;226;11795;975552;963757
2024;7;Centro;Tomate;302;2006;332;19361;666774;647413
2023;11;Norte;Maíz;401;3683;392;9567;1443589;1434022
2024;4;Centro;Trigo;168;1574;264;9933;416118;406185
2023;2;Sur;Manzana;380;4028;352;16619;1416607;1399988
2024;4;Sur;Tomate;145;1850;380;5919;702501;696582
2024;6;Sur;Trigo;272;3301;384;12741;1269069;1256328
2024;11;Norte;Maíz;41;2897;121;9798;349929;340131
2023;11;Centro;Soja;78;736;444;17927;326710;308783
2024;3;Sur;Papa;77;1254;283;15566;355258;339692
2023;1;Centro;Trigo;312;3470;205;1883;711246;709363
2024;12;Centro;Uva;203;3728;197;10415;733335;722920
2023;8;Sur;Maíz;134;1075;293;12085;315201;303116
2024;12;Sur;Uva;250;4781;455;16008;2174064;2158056
2023;5;Centro;Uva;316;292;251;19452;73391;53939
2023;5;Sur;Uva;64;1091;400;9120;436280;427160
2024;11;Centro;Uva;283;3895;139;8820;540353;531533
2023;4;Centro;Uva;107;2891;290;12901;839604;826703
2023;6;Sur;Tomate;300;2594;497;19170;1288362;1269192
2024;3;Norte;Trigo;324;2980;408;17259;1216376;1199117
2023;9;Sur;Trigo;491;1162;184;10649;214052;203403
2023;5;Norte;Papa;345;3507;301;9269;1054134;1044865
2023;3;Centro;Maíz;155;957;193;12805;185132;172327
2024;11;Centro;Soja;161;4770;264;18692;1258421;1239729
2023;1;Norte;Tomate;210;1727;412;11379;711576;700197
2024;10;Centro;Maíz;478;76;408;9744;31045;21301
2023;12;Norte;Tomate;183;646;191;14285;123541;109256
2023;6;Norte;Trigo;201;323;469;9473;151451;141978
2023;2;Centro;Uva;227;3407;337;11679;1148261;1136582
2024;3;Norte;Papa;93;574;252;15605;144631;129026
2023;1;Sur;Papa;291;1611;301;11985;484540;472555
2023;9;Sur;Manzana;438;835;342;13391;285595;272204
2024;8;Centro;Soja;280;3680;324;5861;1192173;1186312
2023;12;Centro;Papa;240;1035;295;2596;304870;302274
2024;2;Norte;Uva;187;2261;302;17863;682754;664891
2024;12;Norte;Trigo;213;4767;171;11155;813060;801905
2023;11;Norte;Soja;497;814;425;8919;346023;337104
2024;8;Norte;Maíz;134;2461;317;11334;779399;768065
2023;12;Sur;Uva;157;4641;152;15628;707428;691800
2024;9;Sur;Uva;17;1401;406;3072;569450;566378
2024;1;Centro;Papa;126;1245;473;10487;588860;578373
2023;5;Norte;Soja;363;4042;479;6624;1935795;1929171
2024;8;Norte;Trigo;224;3290;248;1938;814637;812699
2024;11;Centro;Manzana;110;4733;154;9176;729876;720700
2024;2;Norte;Tomate;379;4854;307;1761;1491925;1490164
2024;4;Norte;Tomate;74;3559;145;13941;516197;502256
2024;7;Norte;Trigo;199;4210;474;2669;1993814;1991145
2023;3;Norte;Trigo;190;4151;173;8128;719908;711780
2024;12;Norte;Tomate;103;1364;201;13091;274314;261223
2023;5;Centro;Manzana;86;1846;263;19315;484852;465537
2024;8;Norte;Soja;79;2902;253;8308;734990;726682
2023;12;Centro;Tomate;378;2506;418;2126;1047182;1045056
2023;10;Norte;Trigo;344;2593;283;7021;732600;725579
2024;3;Sur;Papa;196;2568;168;7437;432220;424783
2024;4;Sur;Maíz;329;3628;207;8039;750561;742522
2024;9;Sur;Manzana;471;1569;304;18587;476427;457840
2023;7;Sur;Uva;218;1517;159;5135;241173;236038
2024;1;Centro;Manzana;319;4081;345;16111;1406557;1390446
2023;12;Centro;Papa;448;2073;326;12964;676420;663456
2023;4;Norte;Papa;471;3652;386;9711;1409234;1399523
2023;4;Sur;Uva;386;2010;475;8904;954911;946007
2024;9;Centro;Trigo;371;1304;465;3283;606230;602947
2024;6;Norte;Tomate;322;4075;478;3477;1949602;1946125
2023;9;Norte;Soja;148;2762;198;4093;546572;542479
2023;12;Centro;Manzana;388;1763;153;8207;269087;260880
2024;6;Sur;Uva;220;4220;221;10394;932240;921846
2023;6;Norte;Manzana;365;1613;458;15841;738802;722961
2024;5;Sur;Papa;328;1332;489;7227;651108;643881
2023;5;Sur;Tomate;19;2451;444;14280;1087582;1073302
2024;2;Sur;Manzana;221;1108;144;4535;159563;155028
2023;8;Norte;Soja;496;1515;479;11582;725640;714058
2024;8;Sur;Papa;443;1136;269;3913;305970;302057
2023;11;Norte;Soja;39;306;104;3340;31738;28398
2024;1;Sur;Tomate;187;3059;277;6289;847221;840932
2024;8;Norte;Manzana;274;2235;118;1597;264691;263094
2023;5;Sur;Maíz;437;4364;318;16025;1385788;1369763
2023;2;Centro;Manzana;471;3797;235;8145;893890;885745
2024;2;Sur;Tomate;362;2106;289;3902;609413;605511
2023;6;Sur;Manzana;104;3619;345;9955;1249532;1239577
2024;11;Norte;Uva;11;2218;448;8694;992599;983905
2023;9;Norte;Manzana;34;185;365;5830;67481;61651
2024;1;Sur;Trigo;471;2512;274;10834;687333;676499
2024;12;Centro;Manzana;309;4009;428;11489;1714930;1703441
2024;6;Centro;Manzana;477;1677;462;16768;775160;758392
2024;9;Norte;Soja;148;4381;148;11364;647950;636586
2024;8;Centro;Maíz;115;2555;313;3160;799127;795967
2024;11;Sur;Soja;236;685;214;14268;146453;132185
2023;6;Norte;Soja;183;1833;119;15485;217797;202312
2023;3;Sur;Papa;76;1366;367;3922;501896;497974
2023;8;Norte;Trigo;214;3082;445;4804;1371829;1367025
2024;9;Norte;Soja;224;3269;165;3368;539908;536540
2024;1;Norte;Uva;84;556;425;16157;236283;220126
2024;12;Norte;Tomate;87;2093;441;9093;923766;914673
2024;9;Centro;Uva;46;2050;466;4932;954767;949835
2023;6;Sur;Tomate;277;4544;206;12552;936564;924012
2023;6;Sur;Manzana;195;1762;462;6608;813304;806696
2024;12;Sur;Papa;177;1625;228;13899;370939;357040
2023;4;Norte;Trigo;465;1859;321;10292;596627;586335
2023;1;Centro;Uva;11;2652;120;10862;318770;307908
2024;10;Sur;Trigo;159;1610;118;6531;189256;182725
2023;8;Centro;Uva;14;3406;388;11412;1322039;1310627
2024;2;Norte;Manzana;38;4412;278;7344;1225609;1218265
2023;12;Sur;Tomate;40;3615;203;17759;732110;714351
2024;1;Centro;Maíz;413;3809;176;8887;671032;662145
2024;2;Norte;Papa;10;628;368;18993;231091;212098
2024;1;Centro;Uva;412;1142;100;17158;114383;97225
2024;1;Sur;Uva;406;2125;422;18997;897515;878518
2023;9;Sur;Manzana;219;2349;132;4679;309363;304684
2024;1;Norte;Papa;138;2749;177;8540;485473;476933
2024;4;Norte;Tomate;289;4286;254;10488;1090744;1080256
2024;10;Norte;Tomate;130;1497;294;8074;440028;431954
2023;6;Centro;Uva;413;1567;242;4996;379214;374218
2024;7;Centro;Maíz;443;2123;228;6695;484638;477943
2023;2;Centro;Maíz;341;1054;486;15235;511791;496556
2024;6;Norte;Trigo;178;2441;357;3366;870534;867168
2023;7;Sur;Papa;156;1592;109;15164;174117;158953
2023;10;Sur;Papa;335;1318;272;7764;358588;350824
2024;10;Centro;Tomate;30;4927;450;16527;2217150;2200623
2023;2;Centro;Trigo;387;611;221;17292;134774;117482
2024;2;Sur;Manzana;119;1630;138;2614;224647;222033
2024;10;Sur;Papa;386;4890;403;15396;1972382;1956986
2024;7;Centro;Trigo;486;4776;342;19800;1635350;1615550
2023;12;Centro;Trigo;288;110;328;17880;36094;18214
2023;1;Sur;Uva;391;4281;121;17888;519842;501954
2024;8;Norte;Tomate;79;247;156;6733;38581;31848
2024;11;Centro;Trigo;170;4035;349;4216;1408296;1404080
2023;3;Sur;Maíz;193;2928;183;5364;536205;530841
2024;11;Sur;Maíz;82;2552;302;13269;769760;756491
2024;6;Sur;Soja;439;2013;318;18861;640033;621172
2024;9;Sur;Tomate;94;1547;213;14829;330130;315301
2023;6;Norte;Uva;180;764;479;5960;366239;360279
2023;9;Sur;Manzana;25;3378;437;19781;1476152;1456371
2023;7;Centro;Soja;58;2268;389;9301;882139;872838
2024;9;Norte;Maíz;188;3675;131;9841;482160;472319
2024;2;Sur;Uva;363;4245;142;8730;604700;595970
2024;12;Norte;Soja;226;550;297;18883;163411;144528
2023;8;Centro;Tomate;319;279;164;17979;45837;27858
2024;8;Sur;Uva;332;3470;491;1978;1704846;1702868
2024;2;Centro;Tomate;183;3418;163;1730;558535;556805
2024;12;Sur;Trigo;280;515;295;1056;151920;150864
2024;4;Sur;Papa;116;1139;246;3243;279795;276552
2023;11;Sur;Trigo;228;2089;356;2701;743162;740461
2023;7;Sur;Tomate;218;3155;152;18670;478330;459660
2024;11;Sur;Uva;63;3252;272;9303;884967;875664
2023;4;Norte;Maíz;331;4918;210;16100;1032190;1016090
2023;4;Sur;Manzana;397;371;455;13998;168842;154844
2024;6;Sur;Maíz;113;3730;116;10393;433538;423145
2024;10;Norte;Uva;389;1466;465;1947;682408;680461
2023;6;Norte;Trigo;161;4077;433;7553;1766156;1758603
2024;10;Norte;Manzana;195;4205;219;1757;921021;919264
2023;3;Norte;Uva;204;1691;416;15866;702983;687117
2024;9;Norte;Tomate;316;1062;112;12580;119464;106884
2023;12;Norte;Maíz;200;2519;487;6651;1226123;1219472
2024;10;Sur;Tomate;39;4737;311;8273;1471502;1463229
2023;11;Sur;Manzana;383;691;221;11033;152925;141892
2023;2;Centro;Manzana;391;3942;245;4535;965908;961373
2023;6;Sur;Maíz;250;2139;127;19677;270712;251035
2024;12;Sur;Tomate;241;4859;496;18488;2408801;2390313
2023;7;Norte;Soja;108;4026;116;9853;465889;456036
2023;12;Norte;Tomate;11;3312;362;1908;1198812;1196904
2024;9;Sur;Manzana;287;729;277;5617;201999;196382
2024;3;Centro;Tomate;5;84;480;11048;40284;29236
2023;10;Norte;Uva;223;1303;198;3311;258515;255204
2023;3;Sur;Trigo;468;1932;313;17020;604388;587368
2024;7;Sur;Soja;234;4167;293;18173;1220681;1202508
2024;4;Centro;Papa;459;4979;381;14585;1897746;1883161
2024;8;Centro;Uva;176;329;127;15017;41849;26832
2024;7;Norte;Trigo;91;2159;178;17555;383266;365711
2024;5;Centro;Papa;45;1462;186;13552;271683;258131
2023;7;Sur;Maíz;127;4979;395;14337;1968000;1953663
2024;3;Sur;Papa;335;1565;176;2885;274908;272023
2023;12;Centro;Uva;302;4217;329;2049;1389080;1387031
2023;2;Centro;Tomate;377;3042;186;11503;566116;554613
2023;6;Centro;Uva;421;470;445;2161;208986;206825
2024;2;Centro;Papa;182;896;477;1815;427276;425461
2023;3;Norte;Manzana;67;3543;307;4766;1089118;1084352
2023;6;Centro;Trigo;488;3946;241;4239;950670;946431
2024;5;Norte;Trigo;169;1125;194;14942;217823;202881
2023;8;Sur;Papa;493;1085;120;9272;130102;120830
2023;9;Centro;Trigo;191;3886;207;1869;805956;804087
2024;11;Norte;Manzana;387;4625;362;6526;1672816;1666290
2023;3;Centro;Uva;213;4917;313;8741;1541234;1532493
2023;12;Sur;Trigo;231;1934;478;5694;923717;918023
2023;10;Sur;Papa;436;936;259;2934;241965;239031
2024;3;Sur;Soja;393;4662;378;18087;1760138;1742051
2024;3;Centro;Soja;52;2291;296;17318;677517;660199
2024;6;Centro;Maíz;228;1065;305;19907;324857;304950
2023;1;Norte;Trigo;7;4684;207;7159;970103;962944
2023;7;Sur;Uva;376;551;282;16719;155371;138652
2024;12;Centro;Papa;179;2171;288;13993;625921;611928
2023;1;Sur;Trigo;450;2261;383;14813;865194;850381
2023;5;Sur;Tomate;103;1062;476;2164;505788;503624
2024;10;Norte;Manzana;120;4579;232;1619;1061092;1059473
2024;8;Norte;Trigo;274;2754;117;8982;321888;312906
2023;4;Norte;Trigo;451;3879;299;4066;1157959;1153893
2023;5;Norte;Soja;372;4491;318;9638;1427150;1417512
2023;4;Sur;Manzana;257;4167;167;3337;697472;694135
2024;12;Norte;Papa;321;4620;404;6594;1867358;1860764
2024;12;Norte;Trigo;419;4535;494;3460;2240154;2236694
2024;4;Norte;Soja;99;4685;478;7820;2240882;2233062
2024;12;Norte;Maíz;277;1570;179;4442;280779;276337
2023;8;Sur;Manzana;384;3772;450;17191;1697966;1680775
2024;2;Norte;Soja;28;1174;382;17326;448233;430907
2024;1;Sur;Soja;120;2732;282;11529;769167;757638
2024;3;Centro;Uva;155;2368;316;18675;748856;730181
2024;9;Sur;Soja;342;480;440;11390;211123;199733
2024;4;Sur;Uva;54;1426;292;15030;416463;401433
2023;10;Norte;Trigo;210;1478;249;6374;368436;362062
2023;5;Centro;Trigo;339;818;297;14142;243191;229049
2024;2;Centro;Maíz;83;181;332;13204;60029;46825
2023;4;Centro;Tomate;74;4136;176;8394;726406;718012
2024;2;Centro;Tomate;31;4152;460;18088;1911415;1893327
2024;2;Sur;Tomate;275;4235;370;1825;1565552;1563727
2023;4;Centro;Uva;54;2409;353;10196;851124;840928
2023;6;Sur;Manzana;296;1655;140;12652;231369;218717
2024;7;Sur;Manzana;251;67;342;17760;22892;5132
2024;10;Sur;Maíz;268;1139;148;1972;169005;167033
2024;3;Centro;Manzana;83;1363;131;12268;179207;166939
2023;3;Norte;Tomate;391;777;311;1443;241585;240142
2024;10;Norte;Tomate;194;3905;261;1754;1019635;1017881
2024;6;Centro;Soja;51;692;336;17023;232180;215157
2024;12;Norte;Manzana;465;3464;136;11363;470030;458667
2023;3;Norte;Trigo;365;2018;272;11897;549683;537786
2024;2;Sur;Trigo;358;3152;170;6396;535556;529160
2024;8;Sur;Soja;476;1800;495;4465;890712;886247
2023;5;Centro;Soja;492;1487;324;3711;482472;478761
2024;1;Centro;Soja;356;895;375;19791;335598;315807
2024;3;Norte;Trigo;193;3916;230;6747;901346;894599
2023;10;Sur;Tomate;420;4502;138;19107;620826;601719
2024;8;Centro;Soja;260;1548;490;2919;759062;756143
2023;4;Centro;Maíz;226;2083;215;18302;446804;428502
2023;7;Centro;Uva;376;322;270;14473;86785;72312
2024;10;Centro;Soja;245;820;360;17965;295159;277194
2024;12;Centro;Uva;273;2245;110;15235;246681;231446
2024;2;Centro;Papa;5;2867;424;16710;1215895;1199185
2024;7;Norte;Soja;38;2773;315;15434;872469;857035
2023;5;Sur;Trigo;450;2042;211;14478;431454;416976
2024;5;Sur;Manzana;83;1517;125;4881;189079;184198
2023;6;Centro;Soja;240;4555;165;2999;751575;748576
2024;9;Sur;Manzana;338;2580;458;15849;1181666;1165817
2024;6;Sur;Papa;381;1904;374;11903;712877;700974
2024;12;Sur;Maíz;353;2715;200;17784;542891;525107
2023;8;Centro;Manzana;102;606;126;15700;76501;60801
2024;7;Centro;Uva;86;2157;376;6445;811571;805126
2024;9;Sur;Tomate;459;625;329;3628;205600;201972
2024;4;Sur;Soja;481;957;262;19040;250552;231512
2024;2;Centro;Papa;419;4661;245;18004;1143996;1125992
2023;7;Norte;Papa;196;4383;187;1246;818438;817192
2024;6;Sur;Manzana;257;3774;368;6212;1388228;1382016
2023;1;Norte;Maíz;413;2023;488;4339;987770;983431
2023;11;Sur;Trigo;42;3707;170;3368;631265;627897
2023;9;Norte;Soja;18;500;339;13186;169425;156239
2023;9;Norte;Papa;396;4360;270;2839;1175761;1172922
2023;12;Norte;Maíz;351;2438;279;7205;679422;672217
2023;2;Centro;Tomate;314;4997;202;5395;1007695;1002300
2024;3;Norte;Papa;390;551;430;16290;236958;220668
2023;5;Norte;Maíz;213;1297;294;4691;381448;376757
2023;5;Norte;Trigo;361;1643;317;8470;521422;512952
2023;1;Sur;Trigo;466;4930;222;4841;1093967;1089126
2024;8;Norte;Papa;93;2936;173;5348;507106;501758
2024;12;Sur;Uva;60;1362;134;18776;182998;164222
2023;8;Norte;Papa;98;4386;386;7060;1691461;1684401
2024;4;Norte;Manzana;97;1308;178;16525;233465;216940
2023;7;Centro;Soja;344;4878;376;5300;1834274;1828974
2023;11;Sur;Maíz;89;3977;256;4338;1018709;1014371
2024;10;Norte;Papa;449;4433;266;6487;1180552;1174065
2023;3;Sur;Soja;249;2268;288;4514;652436;647922
2024;6;Sur;Manzana;26;4657;247;18143;1150652;1132509
2024;10;Centro;Soja;295;2083;140;12280;292141;279861
2023;10;Centro;Papa;489;711;224;11307;159157;147850
2023;12;Centro;Trigo;276;1929;365;10915;705030;694115
2024;9;Centro;Maíz;310;2470;366;12158;904786;892628
2023;1;Centro;Maíz;126;4272;214;9621;916301;906680
2023;5;Centro;Trigo;132;4274;284;11547;1213987;1202440
2023;4;Centro;Uva;117;4334;177;14485;768765;754280
2024;8;Centro;Papa;431;376;184;3459;69240;65781
2024;11;Norte;Maíz;277;537;109;6273;58651;52378
2023;12;Sur;Papa;340;4896;459;19102;2245795;2226693
2024;1;Centro;Manzana;446;3728;184;10457;686996;676539
2024;9;Centro;Papa;134;3619;191;6423;691265;684842
2024;6;Sur;Soja;136;3945;212;18692;835709;817017
2024;4;Norte;Trigo;89;4629;151;18434;698794;680360
2024;12;Sur;Uva;427;2163;356;6479;769401;762922
2023;9;Sur;Papa;486;1918;130;16419;249455;233036
2023;11;Centro;Uva;354;3022;154;3249;464421;461172
2023;5;Sur;Uva;394;4238;358;3809;1516780;1512971
2024;5;Sur;Manzana;85;3032;236;3921;715128;711207
2024;12;Centro;Tomate;491;3493;383;5676;1338448;1332772
2023;5;Centro;Trigo;477;2730;323;3417;881708;878291
2024;1;Centro;Uva;329;1780;202;17916;360290;342374
2023;1;Centro;Maíz;73;4123;360;14463;1485641;1471178
2023;8;Sur;Soja;152;1787;147;9167;261813;252646
2023;12;Sur;Maíz;452;4222;315;2469;1328072;1325603
2024;8;Norte;Manzana;20;807;275;8292;221812;213520
2024;12;Norte;Manzana;311;3225;207;7931;668059;660128
2023;6;Sur;Maíz;109;3798;342;2091;1297397;1295306
2023;12;Norte;Trigo;169;2986;449;17363;1339311;1321948
2023;11;Sur;Maíz;492;3747;500;1260;1871851;1870591
2023;4;Norte;Papa;205;1721;343;11456;590492;579036
2024;2;Centro;Maíz;201;762;262;14435;199553;185118
2024;2;Norte;Soja;430;2479;190;10377;471208;460831
2023;9;Centro;Soja;189;3979;203;16813;807100;790287
2023;5;Centro;Tomate;326;1402;292;5301;409076;403775
2024;4;Centro;Soja;269;2615;247;8207;645670;637463
2024;10;Centro;Maíz;367;687;466;17476;319819;302343
2023;1;Norte;Soja;104;115;247;9556;28442;18886
2023;7;Sur;Trigo;346;3297;249;14795;822206;807411
2023;3;Centro;Uva;324;4763;253;7125;1206992;1199867
2024;6;Norte;Soja;218;1956;435;2924;850175;847251
2024;5;Centro;Papa;282;1105;360;7683;398154;390471
2024;5;Norte;Trigo;166;1792;346;19922;619441;599519
2023;11;Norte;Tomate;443;4551;234;19660;1063387;1043727
2023;5;Norte;Papa;161;3267;427;14331;1395532;1381201
2024;1;Sur;Maíz;426;2007;115;10945;231507;220562
2024;1;Norte;Uva;255;4879;448;18294;2187353;2169059
2023;3;Norte;Maíz;370;1571;305;1306;479312;478006
2024;12;Sur;Uva;101;4016;259;5231;1041349;1036118
2024;10;Sur;Uva;22;1685;299;7028;503596;496568
2023;4;Norte;Maíz;331;1132;367;13207;415410;402203
2024;5;Sur;Papa;453;3991;105;7658;419494;411836
2023;2;Centro;Papa;387;1311;449;7336;588141;580805
2023;8;Centro;Uva;101;953;279;14896;265601;250705
2023;11;Sur;Papa;5;4560;237;10630;1081586;1070956
2023;11;Sur;Uva;220;955;155;18256;148312;130056
2023;2;Norte;Uva;136;610;276;2141;168232;166091
2023;9;Sur;Trigo;264;2710;299;18049;809016;790967
2023;2;Norte;Manzana;129;4830;261;9400;1262852;1253452
2024;9;Centro;Trigo;86;1427;371;1951;530073;528122
2023;7;Sur;Maíz;287;1534;268;10249;411664;401415
2023;8;Norte;Manzana;175;3776;485;13936;1829736;1815800
2024;11;Norte;Soja;63;260;340;15455;88325;72870
2024;2;Centro;Maíz;36;1554;423;5722;657326;651604
2024;7;Sur;Tomate;165;88;144;13812;12649;-1163
2023;12;Centro;Trigo;288;3133;259;5008;811196;806188
2024;6;Norte;Papa;110;907;235;11060;212909;201849
2023;4;Norte;Trigo;109;4886;328;14056;1601582;1587526
2023;7;Sur;Papa;443;235;444;7655;104446;96791
2023;4;Norte;Manzana;232;1219;131;18155;160103;141948
2023;2;Sur;Tomate;192;4908;129;14027;633279;619252
2024;10;Centro;Manzana;74;4847;440;5030;2133310;2128280
2024;12;Sur;Tomate;322;2188;185;1521;405086;403565
2023;7;Sur;Trigo;468;2689;368;2400;988208;985808
2023;8;Norte;Papa;294;2895;317;12930;918149;905219
2023;2;Norte;Manzana;91;2816;433;4723;1219779;1215056
2024;5;Sur;Tomate;374;713;150;7579;106979;99400
2023;1;Norte;Uva;366;2554;152;19242;387978;368736
2023;7;Norte;Maíz;476;2380;323;5781;768097;762316
2024;8;Norte;Maíz;60;3291;479;13873;1574908;1561035
2024;6;Sur;Manzana;117;4720;266;19782;1255520;1235738
2023;5;Norte;Papa;17;338;231;17526;78004;60478
2024;6;Sur;Uva;444;4238;343;12043;1452278;1440235
2024;2;Norte;Manzana;22;4940;472;17375;2332569;2315194
2023;1;Centro;Trigo;186;130;435;18101;56520;38419
2024;7;Norte;Tomate;465;974;498;1642;485237;483595
2023;7;Norte;Trigo;117;4234;109;19932;461633;441701
2024;10;Sur;Maíz;233;3685;145;12885;534841;521956
2023;11;Sur;Tomate;175;2086;344;8549;717146;708597
2023;10;Norte;Manzana;299;342;428;14397;146455;132058
2023;2;Centro;Trigo;193;3378;214;16074;723230;707156
2024;2;Norte;Soja;430;1326;196;14771;259472;244701
2023;1;Norte;Papa;469;1206;415;1949;500237;498288
2024;10;Centro;Uva;83;3180;123;17905;389709;371804
2023;8;Sur;Uva;150;1439;248;15732;356512;340780
2023;8;Norte;Papa;411;365;302;17738;110347;92609
2024;1;Sur;Soja;186;4244;324;18866;1375650;1356784
2023;12;Sur;Maíz;290;1536;391;10839;601267;590428
2023;11;Centro;Tomate;254;3907;242;13823;945260;931437
2024;8;Centro;Papa;358;38;345;19599;13113;-6486
2023;9;Sur;Soja;318;1023;334;19921;341835;321914
2023;4;Norte;Manzana;200;2712;319;15690;865264;849574
2023;1;Sur;Uva;327;837;356;7339;298131;290792
2023;1;Norte;Soja;75;4456;204;11956;908044;896088
2024;3;Norte;Maíz;252;2034;134;4765;272271;267506
2024;5;Centro;Maíz;150;308;148;3827;45495;41668
2023;5;Norte;Trigo;110;1875;190;3058;355931;352873
2024;9;Norte;Papa;267;4026;300;12519;1208122;1195603
2023;10;Sur;Trigo;300;2121;436;1730;925138;923408
2024;12;Centro;Uva;74;764;381;2832;290717;287885
2023;2;Norte;Soja;474;779;416;9600;323768;314168
2023;2;Norte;Tomate;197;3745;240;16618;900261;883643
2023;6;Centro;Tomate;72;1248;262;8170;326801;318631
2023;9;Sur;Maíz;498;4939;257;5179;1271644;1266465
2023;1;Centro;Tomate;309;2223;177;7299;392915;385616
2023;9;Centro;Tomate;56;1916;124;8830;238523;229693
2024;9;Norte;Uva;374;1574;336;12439;529446;517007
2023;9;Norte;Tomate;367;1228;496;5802;608707;602905
2024;5;Sur;Soja;289;4611;167;7615;768792;761177
2023;9;Norte;Tomate;409;1367;119;7762;162222;154460
2024;11;Norte;Manzana;478;3849;412;6543;1585057;1578514
2024;4;Centro;Tomate;338;1470;201;5883;295514;289631
2024;2;Norte;Tomate;13;3995;432;16739;1725281;1708542
2023;6;Sur;Trigo;255;1426;382;1666;544119;542453
2023;4;Centro;Soja;435;2863;478;1276;1369287;1368011
2024;6;Sur;Maíz;336;4866;264;15063;1282532;1267469
2023;3;Centro;Trigo;302;4938;365;1881;1801333;1799452
2024;6;Norte;Papa;439;1438;286;3060;411182;408122
2023;2;Centro;Soja;188;4388;352;15677;1545629;1529952
2024;2;Centro;Manzana;183;4484;280;19466;1254803;1235337
2024;9;Norte;Soja;202;4303;175;7702;754961;747259
2023;7;Norte;Papa;132;3072;303;10429;931308;920879
2024;3;Sur;Papa;24;3081;311;16853;959516;942663
2023;11;Sur;Papa;476;565;424;1158;239696;238538
2024;1;Norte;Uva;415;365;394;16996;143887;126891
2024;8;Norte;Maíz;426;1573;366;6229;574963;568734
2023;6;Norte;Tomate;332;3510;145;8956;510179;501223
2023;7;Centro;Soja;69;1050;388;13566;407663;394097
2023;9;Centro;Uva;186;2696;300;3526;809124;805598
2024;5;Centro;Tomate;245;4484;458;8803;2052058;2043255
2023;1;Norte;Tomate;373;4785;468;7574;2239141;2231567
2024;12;Sur;Manzana;28;2563;122;9733;312840;303107
2024;10;Norte;Papa;388;1789;428;18522;766157;747635
2023;7;Centro;Maíz;435;85;115;8257;9782;1525
2023;5;Centro;Manzana;459;4336;247;4283;1070428;1066145
2024;3;Norte;Trigo;87;3329;317;16909;1055027;1038118
2024;12;Norte;Uva;474;2359;159;12802;375647;362845
2023;9;Centro;Uva;323;2783;399;8896;1109109;1100213
2023;1;Centro;Maíz;189;2272;103;19803;234788;214985
2023;1;Centro;Tomate;443;3239;167;14526;542338;527812
2023;1;Norte;Uva;320;2126;332;19140;706512;687372
2023;3;Centro;Maíz;103;402;386;12278;155076;142798
2024;12;Centro;Uva;66;1118;467;14242;521726;507484
2024;6;Sur;Uva;290;4372;382;19690;1670978;1651288
2024;10;Norte;Papa;481;620;369;3570;228600;225030
2024;11;Sur;Trigo;26;2785;258;1324;717806;716482
2023;3;Sur;Papa;463;4008;101;10721;402844;392123
2023;8;Centro;Trigo;216;682;148;6645;100977;94332
2023;10;Norte;Uva;130;3687;314;19329;1157054;1137725
2024;2;Centro;Manzana;417;40;370;15404;14802;-602
2024;9;Norte;Tomate;429;1410;267;5486;376442;370956
2023;3;Sur;Uva;46;4081;392;3430;1600854;1597424
2023;5;Norte;Trigo;102;626;309;18229;193271;175042
2024;10;Centro;Trigo;453;4644;130;14156;602187;588031
2024;8;Centro;Trigo;35;2796;177;1567;494361;492794
2023;2;Centro;Uva;162;880;436;3179;383680;380501
2023;6;Norte;Maíz;116;4206;390;3019;1640214;1637195
2024;12;Sur;Manzana;406;3614;458;16919;1654851;1637932
2023;5;Sur;Maíz;251;1422;147;19704;209062;189358
2023;10;Norte;Tomate;126;2749;496;19030;1363751;1344721
2023;9;Centro;Uva;277;950;184;4909;174572;169663
2024;12;Sur;Trigo;298;350;105;9015;36649;27634
2024;5;Centro;Manzana;402;2918;499;4420;1455994;1451574
2024;2;Norte;Manzana;475;4143;212;15885;880097;864212
2024;5;Centro;Soja;477;669;367;17740;245663;227923
2024;12;Sur;Tomate;211;2043;171;8485;348679;340194
2024;4;Sur;Manzana;114;1570;332;19664;521381;501717
2024;11;Centro;Uva;444;3467;462;5131;1600402;1595271
2023;7;Norte;Trigo;282;1666;228;11652;379965;368313
2023;6;Centro;Trigo;455;2985;368;15379;1098779;1083400
2023;2;Norte;Manzana;60;1059;175;15903;185494;169591
2023;12;Centro;Maíz;379;463;350;16913;162013;145100
2023;11;Sur;Tomate;407;1714;235;10470;402070;391600
2023;11;Norte;Trigo;61;2794;184;17849;515437;497588
2023;5;Norte;Manzana;432;828;225;12540;186524;173984
2024;7;Norte;Trigo;486;4878;172;18871;836772;817901
2024;11;Sur;Manzana;295;22;461;5597;10137;4540
2023;7;Centro;Tomate;118;3989;259;5536;1032632;1027096
2023;5;Sur;Manzana;385;930;198;17709;184242;166533
2024;12;Norte;Soja;389;4930;279;10957;1377245;1366288
2023;9;Centro;Manzana;312;2428;228;5162;554094;548932
2023;4;Sur;Manzana;345;1324;398;1303;526647;525344
2024;11;Norte;Uva;481;3687;488;6067;1801063;1794996
2023;3;Norte;Tomate;202;2027;275;6024;557851;551827
2024;4;Sur;Uva;425;1238;444;8715;550180;541465
2023;5;Sur;Manzana;325;4802;326;12226;1567133;1554907
2024;6;Sur;Tomate;183;2444;163;3631;398103;394472
2024;3;Norte;Soja;389;2878;376;14412;1082848;1068436
2024;2;Sur;Tomate;223;2525;305;16037;771059;755022
2023;4;Norte;Trigo;281;1448;360;12647;521628;508981
2024;5;Sur;Uva;441;4174;456;13569;1902801;1889232
2023;4;Norte;Tomate;20;3553;276;3369;981232;977863
2023;11;Norte;Soja;496;3185;460;12659;1466597;1453938
2023;12;Centro;Papa;383;1791;400;1528;716884;715356
2023;3;Sur;Manzana;65;2273;295;11502;671535;660033
2024;8;Sur;Tomate;58;1979;341;5675;675413;669738
2024;10;Norte;Manzana;172;221;230;19047;50881;31834
2023;4;Norte;Maíz;30;517;493;3341;255108;251767
2023;2;Norte;Trigo;340;341;367;14919;125127;110208
2024;2;Centro;Uva;480;560;118;15730;65822;50092
2023;1;Centro;Trigo;69;951;231;16256;219348;203092
2024;4;Norte;Maíz;104;737;349;5905;257456;251551
2023;10;Sur;Maíz;78;4985;123;16539;610812;594273
2023;9;Sur;Uva;196;2872;110;16255;314628;298373
2024;11;Centro;Tomate;175;3253;280;9884;910873;900989
2023;7;Centro;Maíz;277;658;233;10143;153367;143224
2024;12;Norte;Papa;381;2747;275;6950;756304;749354
2023;10;Sur;Manzana;191;2757;205;2360;565406;563046
2023;7;Norte;Manzana;27;1019;166;6127;169042;162915
2023;7;Centro;Soja;395;1560;376;15252;586030;570778
2024;8;Sur;Maíz;432;813;306;9730;248640;238910
2023;1;Sur;Maíz;185;4090;180;4925;736445;731520
2023;10;Centro;Papa;331;4319;228;9463;984041;974578
2023;10;Norte;Trigo;112;4274;337;18412;1439141;1420729
2023;8;Norte;Trigo;339;3411;129;2242;439644;437402
2024;4;Sur;Manzana;166;4251;159;9784;675824;666040
2024;4;Centro;Manzana;306;4621;129;10797;597495;586698
2023;4;Sur;Tomate;497;3171;425;7406;1347453;1340047
2024;6;Centro;Uva;456;4558;401;14965;1827576;1812611
2023;7;Norte;Papa;210;4165;401;14733;1671539;1656806
2023;6;Centro;Uva;82;537;387;18824;207567;188743
2023;1;Norte;Uva;20;3308;368;4626;1216517;1211891
2024;12;Centro;Soja;331;1033;291;11074;300396;289322
2024;8;Sur;Uva;100;3744;357;17568;1336271;1318703
2024;10;Norte;Soja;151;442;115;9031;50980;41949
2024;11;Sur;Uva;6;1186;349;4188;413428;409240
2024;7;Sur;Papa;14;410;411;3945;168572;164627
2024;6;Norte;Soja;438;2114;300;7765;634496;626731
2024;6;Norte;Trigo;129;3060;243;19858;743611;723753
2024;5;Sur;Soja;85;2243;211;11807;473206;461399
2024;6;Sur;Soja;489;2455;357;11204;876730;865526
2023;12;Sur;Papa;144;4710;377;10352;1776235;1765883
2024;9;Sur;Papa;330;2845;448;5599;1275670;1270071
2024;10;Norte;Soja;154;2523;237;5313;597774;592461
2024;9;Norte;Maíz;292;1783;408;3218;727304;724086
2024;10;Sur;Papa;365;1106;325;14786;358941;344155
2024;8;Centro;Tomate;344;938;453;18536;425036;406500
2024;10;Centro;Tomate;133;1961;311;1056;610106;609050
2024;9;Norte;Trigo;442;1983;307;13533;608880;595347
2024;10;Sur;Uva;243;1564;331;1143;517919;516776
2024;8;Sur;Soja;62;2788;400;8218;1114447;1106229
2024;8;Norte;Maíz;202;4431;486;9559;2152934;2143375
2024;1;Centro;Trigo;215;1004;129;1615;129948;128333
2023;10;Centro;Soja;406;622;121;9062;75492;66430
2023;11;Centro;Papa;394;2603;475;12520;1236477;1223957
2024;5;Norte;Tomate;49;605;312;6977;188730;181753
2024;4;Centro;Manzana;101;851;346;12419;294412;281993
2023;2;Norte;Maíz;283;4449;293;10780;1303424;1292644
2024;8;Norte;Manzana;27;868;137;11681;119315;107634
2023;3;Sur;Tomate;414;454;407;7984;184887;176903
2023;4;Centro;Uva;465;1798;399;5971;717204;711233
2023;12;Norte;Uva;395;4327;225;1944;972190;970246
2023;7;Centro;Manzana;339;3464;223;10114;770740;760626
2023;10;Centro;Papa;48;3962;435;8078;1724025;1715947
2024;9;Sur;Soja;31;4697;129;19130;605631;586501
2023;2;Centro;Papa;286;1040;452;13312;470538;457226
2024;3;Sur;Manzana;101;1305;203;6783;264471;257688
2024;4;Norte;Papa;467;2073;337;10751;698995;688244
2023;10;Centro;Tomate;40;1457;474;7907;691201;683294
2023;1;Norte;Maíz;113;2055;371;18473;762919;744446
2024;7;Centro;Papa;59;4629;266;3957;1230249;1226292
2023;2;Norte;Tomate;196;2860;376;19996;1074817;1054821
2023;5;Centro;Maíz;223;3834;238;7047;910920;903873
2024;1;Centro;Uva;189;2078;211;7249;438250;431001
2024;3;Centro;Soja;73;3771;499;17347;1880485;1863138
2023;12;Centro;Manzana;321;2285;400;4759;914731;909972
2024;2;Centro;Uva;134;1818;358;5263;650644;645381
2023;1;Centro;Soja;59;1321;242;11281;319841;308560
2023;7;Centro;Uva;382;4065;120;2902;486418;483516
2023;5;Centro;Trigo;101;2461;112;3567;276666;273099
2024;1;Centro;Uva;340;1099;322;11190;353515;342325
2024;6;Norte;Tomate;91;1682;405;9075;680890;671815
2024;5;Sur;Maíz;298;3685;315;3994;1160591;1156597
2024;3;Centro;Uva;123;4542;436;6229;1981720;1975491
2024;12;Sur;Papa;212;4934;113;3010;559368;556358
2023;7;Centro;Soja;338;4364;247;8377;1076599;1068222
2023;11;Centro;Uva;417;2013;195;14036;392193;378157
2023;10;Norte;Maíz;158;4208;279;18214;1173653;1155439
2023;9;Norte;Tomate;39;4874;129;1048;628502;627454
2024;9;Sur;Trigo;83;1134;482;5210;546191;540981
2023;9;Norte;Soja;71;1231;189;18562;233028;214466
2024;2;Norte;Manzana;347;2870;469;15838;1345800;1329962
2023;3;Sur;Maíz;417;2283;270;17038;617232;600194
2024;7;Norte;Manzana;38;3000;494;8878;1482630;1473752
2024;5;Centro;Maíz;101;2520;322;17454;810482;793028
2023;2;Sur;Maíz;173;246;472;16347;116193;99846
2023;3;Sur;Tomate;173;1154;102;8879;117870;108991
2023;10;Centro;Tomate;155;3263;399;19161;1302916;1283755
2023;6;Norte;Tomate;75;3792;461;14254;1748946;1734692
2024;7;Sur;Uva;7;776;156;8380;120971;112591
2023;9;Sur;Papa;318;2691;138;3228;372569;369341
2023;1;Centro;Maíz;36;2675;270;10814;721795;710981
2024;11;Centro;Soja;291;1769;473;9888;837568;827680
2023;7;Norte;Manzana;86;3501;317;7391;1109642;1102251
2023;8;Sur;Tomate;47;2825;311;10429;878519;868090
2023;12;Norte;Uva;395;3523;156;19790;551173;531383
2023;3;Norte;Tomate;109;505;100;1637;50662;49025
2023;4;Centro;Manzana;5;3190;424;18333;1352751;1334418
2024;10;Sur;Manzana;65;3940;135;11096;532018;520922
2023;6;Sur;Maíz;274;2082;354;4587;736070;731483
2023;10;Sur;Tomate;184;347;466;2111;161650;159539
2023;7;Centro;Manzana;228;3959;183;9367;726318;716951
2023;4;Centro;Papa;10;3118;366;1722;1141531;1139809
2023;8;Centro;Papa;107;1827;131;5866;240214;234348
2024;5;Centro;Tomate;14;146;342;11139;49859;38720
2023;1;Centro;Uva;75;2565;166;18086;424687;406601
2024;4;Sur;Manzana;94;4425;394;3128;1745132;1742004
2024;3;Norte;Maíz;230;925;220;10118;203953;193835
2023;9;Sur;Maíz;162;3548;285;3517;1012457;1008940
2023;8;Norte;Uva;232;2110;340;18533;716915;698382
2023;1;Centro;Maíz;409;2917;169;15228;491544;476316
2023;11;Norte;Trigo;130;2924;397;15179;1159834;1144655
2024;6;Sur;Tomate;448;1992;221;19262;440352;421090
2023;9;Sur;Maíz;213;3880;365;10675;1416006;1405331
2023;7;Norte;Papa;101;4538;163;1309;741101;739792
2023;4;Centro;Manzana;78;3577;375;4952;1342269;1337317
2023;1;Centro;Soja;119;1008;151;14871;152490;137619
2023;12;Sur;Uva;195;2157;270;10692;582692;572000
2023;2;Norte;Soja;499;4704;199;1015;935532;934517
2024;12;Centro;Maíz;174;405;399;17989;161737;143748
2024;5;Centro;Soja;311;3608;205;17005;738954;721949
2023;12;Sur;Soja;452;4520;453;15278;2046159;2030881
2023;11;Centro;Trigo;208;948;457;15817;432980;417163
2023;5;Norte;Papa;60;1646;179;10759;293943;283184
2024;8;Sur;Uva;212;2734;346;16664;944706;928042
2023;6;Sur;Papa;45;2520;135;7412;340427;333015
2024;8;Norte;Trigo;36;4646;257;11196;1192210;1181014
2023;2;Sur;Trigo;19;1659;385;9507;639262;629755
2023;3;Centro;Soja;66;3700;364;5820;1345949;1340129
2023;6;Centro;Tomate;159;3445;350;8835;1205337;1196502
2023;12;Norte;Manzana;288;3211;213;2849;684007;681158
2024;10;Centro;Manzana;213;4189;251;14587;1052319;1037732
2024;3;Norte;Soja;324;4376;141;2953;617804;614851
2023;6;Norte;Manzana;498;2301;388;13731;891891;878160
2023;6;Centro;Trigo;191;4493;302;7840;1354909;1347069
2024;2;Norte;Papa;446;223;384;6066;85523;79457
2024;7;Centro;Manzana;134;3247;200;3415;648036;644621
2024;12;Sur;Uva;131;3872;230;3389;889708;886319
2024;2;Sur;Soja;296;68;234;17211;15891;-1320
2023;6;Norte;Tomate;118;2940;110;1763;324282;322519
2024;1;Centro;Soja;203;4948;236;18199;1169806;1151607
2023;3;Centro;Maíz;17;2981;421;7255;1255955;1248700
2024;2;Sur;Soja;275;1537;459;18261;705360;687099
2024;7;Sur;Trigo;93;132;307;8173;40562;32389
2024;4;Centro;Papa;219;3729;282;11518;1052324;1040806
2024;8;Norte;Papa;448;1446;112;11252;162429;151177
2024;6;Sur;Uva;282;1172;452;13447;529369;515922
2023;12;Norte;Manzana;451;3310;105;16089;348212;332123
2023;10;Norte;Trigo;478;3355;478;10395;1603355;1592960
2024;4;Sur;Maíz;485;2496;296;13067;738042;724975
2024;5;Norte;Trigo;207;571;237;6287;135196;128909
2023;9;Norte;Soja;78;3991;470;14461;1874533;1860072
2024;7;Centro;Trigo;29;1747;110;14402;191751;177349
2024;10;Norte;Trigo;105;914;333;8433;303969;295536
2023;9;Centro;Uva;180;3564;320;12284;1138947;1126663
2024;7;Sur;Maíz;431;4500;188;5826;844785;838959
2024;12;Sur;Soja;121;1736;272;4664;471411;466747
2023;1;Centro;Tomate;170;2933;361;11528;1058549;1047021
2023;12;Sur;Uva;45;3541;391;1497;1384000;1382503
2023;8;Norte;Tomate;433;3916;100;8641;392736;384095
2024;4;Norte;Uva;348;944;475;5643;448155;442512
2023;3;Norte;Papa;428;84;166;6056;13928;7872
2023;7;Sur;Uva;370;304;193;1131;58803;57672
2023;12;Norte;Manzana;124;30;205;6443;6162;-281
2023;3;Sur;Trigo;101;3252;115;18241;374403;356162
2023;8;Norte;Papa;149;1048;149;14443;156383;141940
2023;6;Centro;Maíz;220;4665;495;9712;2307029;2297317
2024;5;Sur;Tomate;233;1119;226;9221;252995;243774
2024;4;Sur;Uva;317;3781;146;16660;552480;535820
2023;8;Norte;Trigo;134;381;143;7147;54407;47260
2023;8;Sur;Maíz;356;4923;388;12588;1909041;1896453
2023;12;Sur;Manzana;381;1184;442;5604;523127;517523
2024;1;Centro;Maíz;322;1174;203;10452;238064;227612
2024;9;Centro;Trigo;476;1102;108;18942;119413;100471
2024;5;Norte;Manzana;141;1293;189;17399;244687;227288
2024;4;Centro;Maíz;328;2021;123;4605;247795;243190
2024;6;Norte;Manzana;341;855;141;14284;120863;106579
2024;6;Norte;Uva;277;2001;273;2607;545473;542866
2024;2;Norte;Uva;121;530;192;12709;101744;89035
2024;8;Sur;Trigo;310;4476;306;3016;1371357;1368341
2024;7;Centro;Trigo;372;4206;201;4574;847088;842514
2023;1;Norte;Manzana;98;4766;476;14541;2269617;2255076
2023;5;Centro;Soja;172;252;462;8274;116520;108246
2023;12;Norte;Papa;446;2810;327;10935;918083;907148
2023;6;Centro;Maíz;207;4617;242;16748;1116252;1099504
2024;4;Centro;Maíz;345;2906;252;7406;733649;726243
2024;2;Norte;Soja;153;2612;265;12826;691501;678675
2023;4;Sur;Soja;406;2283;391;18472;892721;874249
2024;1;Centro;Soja;187;1551;281;2361;435304;432943
2023;7;Sur;Tomate;417;2775;443;5473;1228465;1222992
2024;2;Sur;Tomate;156;2124;478;8319;1014507;1006188
2023;2;Norte;Manzana;78;4501;234;9667;1054944;1045277
2024;9;Norte;Tomate;369;4717;324;10481;1529629;1519148
2024;5;Norte;Uva;405;3093;138;9520;426896;417376
2023;2;Centro;Uva;278;1867;180;18570;336415;317845
2024;11;Norte;Trigo;46;779;265;4536;206739;202203
2023;9;Norte;Manzana;216;1432;182;2773;261311;258538
2023;9;Centro;Maíz;105;416;451;11255;187458;176203
2023;1;Centro;Papa;49;2982;163;3558;486990;483432
2023;11;Norte;Trigo;86;1882;282;6079;531213;525134
2024;3;Norte;Maíz;21;2704;342;15341;925525;910184
2024;4;Norte;Maíz;77;2279;377;10981;858613;847632
2024;7;Norte;Manzana;18;4759;253;4524;1205122;1200598
2023;10;Sur;Soja;437;1191;448;9998;533139;523141
2024;4;Sur;Soja;161;1449;327;14697;474301;459604
2023;2;Norte;Trigo;227;3063;276;14606;844775;830169
2024;7;Sur;Soja;136;3343;127;14429;424227;409798
2024;6;Centro;Maíz;342;2907;286;17039;831053;814014
2024;3;Sur;Soja;408;2913;428;8140;1247609;1239469
2023;6;Sur;Tomate;380;238;346;9785;82305;72520
2024;11;Norte;Soja;380;3969;433;15901;1718021;1702120
2024;6;Sur;Maíz;51;1903;298;4280;566333;562053
2023;12;Sur;Manzana;111;1323;147;3212;194984;191772
2024;5;Sur;Trigo;112;1080;105;16213;113897;97684
2023;4;Sur;Papa;269;984;221;9078;217749;208671
2024;10;Centro;Soja;209;1748;379;16936;662842;645906
2023;12;Norte;Uva;83;3295;416;17997;1371050;1353053
2023;1;Norte;Uva;159;767;218;15274;167436;152162
2024;10;Centro;Maíz;275;3105;298;1868;926097;924229
2023;6;Sur;Papa;480;330;268;18195;88589;70394
2023;2;Centro;Papa;489;2331;264;17042;615874;598832
2023;3;Sur;Tomate;251;565;193;16407;108785;92378
2023;8;Centro;Papa;23;4949;155;17254;764868;747614
2023;10;Norte;Uva;350;1396;179;2744;249437;246693
2023;6;Norte;Manzana;440;4773;122;3256;582926;579670
2024;3;Norte;Maíz;30;3057;179;12859;547967;535108
2023;7;Sur;Maíz;221;2437;104;6423;252668;246245
2023;4;Sur;Soja;158;2014;351;6089;706713;700624
2024;9;Centro;Soja;158;1940;227;7608;439507;431899
2024;5;Centro;Soja;178;4851;489;10717;2373400;2362683
2024;3;Norte;Uva;96;4780;177;18853;848402;829549
2024;2;Sur;Uva;437;2173;238;18897;517891;498994
2024;11;Centro;Uva;342;3877;243;5876;942654;936778
2024;2;Sur;Uva;484;2436;103;18835;251834;232999
2024;3;Sur;Uva;185;3803;436;4007;1656891;1652884
2023;2;Norte;Uva;135;2523;113;15325;284594;269269
2023;4;Norte;Manzana;454;3813;476;4124;1815255;1811131
2024;2;Sur;Uva;485;2337;457;2753;1067612;1064859
2023;10;Sur;Papa;302;627;314;18996;197010;178014
2023;9;Sur;Papa;279;2175;317;4275;690432;686157
2023;2;Sur;Tomate;277;3318;362;9747;1199490;1189743
2024;9;Norte;Manzana;496;1002;255;13443;255330;241887
2024;6;Centro;Soja;421;1387;359;19433;497780;478347
2023;1;Norte;Trigo;80;4391;118;1824;517743;515919
2024;4;Centro;Uva;181;3184;122;14880;387238;372358
2023;1;Sur;Tomate;188;4792;283;12041;1355609;1343568
2023;6;Centro;Trigo;323;1315;320;2081;420603;418522
2023;4;Norte;Papa;135;4843;455;12517;2204195;2191678
2023;3;Norte;Tomate;367;3088;142;17876;438064;420188
2024;3;Sur;Tomate;53;2696;429;5764;1156746;1150982
2024;9;Norte;Maíz;59;2993;184;9266;550772;541506
2024;6;Sur;Papa;158;2533;258;12183;652577;640394
2023;9;Norte;Papa;359;3592;227;17712;814091;796379
2024;5;Norte;Manzana;204;1495;260;13877;388790;374913
2023;2;Sur;Tomate;312;2110;160;10982;338022;327040
2024;8;Centro;Uva;360;4591;301;9968;1383865;1373897
2023;5;Norte;Papa;377;3725;421;15639;1566959;1551320
2023;2;Centro;Tomate;122;2011;277;5674;556263;550589
2023;4;Norte;Manzana;267;1397;296;5316;413861;408545
2024;9;Norte;Uva;50;3193;440;16314;1403355;1387041
2024;4;Norte;Manzana;306;1040;382;10695;397717;387022
2024;12;Norte;Maíz;360;1775;296;16814;525720;508906
2024;12;Centro;Uva;404;4773;203;9379;969301;959922
2023;12;Centro;Tomate;412;1230;454;2214;558383;556169
2024;4;Norte;Papa;193;4940;331;12638;1634201;1621563
2024;2;Norte;Papa;314;4981;188;11713;938719;927006
2023;12;Centro;Tomate;322;3816;208;16977;792392;775415
2023;6;Sur;Tomate;133;2424;421;13071;1021110;1008039
2023;11;Sur;Tomate;53;4355;118;4136;512409;508273
2024;2;Centro;Soja;29;1628;497;7618;808856;801238
2023;12;Norte;Uva;270;1273;152;6265;193674;187409
2023;7;Norte;Papa;122;881;418;8965;368637;359672
2023;3;Sur;Uva;468;844;258;10597;217676;207079
2024;3;Sur;Manzana;148;2832;297;9708;840792;831084
2023;5;Centro;Papa;446;928;452;7569;419697;412128
2024;3;Sur;Soja;204;1734;265;18875;459787;440912
2024;2;Centro;Tomate;161;2423;315;6213;763245;757032
2023;10;Sur;Maíz;491;1323;120;12881;158390;145509
2023;9;Sur;Tomate;352;4508;101;5228;455038;449810
2024;2;Sur;Tomate;138;2115;198;5409;418601;413192
2023;11;Norte;Soja;404;2578;372;1590;959609;958019
2023;2;Norte;Uva;152;1148;149;19590;170489;150899
2024;8;Norte;Papa;340;219;146;3708;31865;28157
2024;9;Sur;Tomate;75;1074;264;6981;283944;276963
2023;7;Centro;Papa;237;4921;359;13221;1767279;1754058
2024;3;Centro;Trigo;338;2230;385;18131;858171;840040
2023;9;Centro;Manzana;303;243;171;14785;41645;26860
2023;3;Centro;Uva;158;802;132;7553;105736;98183
2023;5;Norte;Papa;94;3120;476;18881;1485619;1466738
2024;9;Norte;Maíz;338;2176;204;2379;444492;442113
2023;12;Sur;Manzana;203;344;441;8360;151821;143461
2023;3;Sur;Maíz;165;1369;445;4770;609753;604983
2023;7;Centro;Tomate;30;1224;409;15449;500628;485179
2024;12;Norte;Manzana;125;4429;168;10088;741990;731902
2024;1;Centro;Papa;305;293;429;2546;125615;123069
2024;4;Sur;Manzana;216;222;408;7208;90509;83301
2024;4;Sur;Tomate;67;1668;339;17350;564935;547585
2024;7;Centro;Soja;455;4088;235;9875;960189;950314
2023;8;Sur;Uva;440;4857;205;2295;995685;993390
2024;1;Centro;Maíz;72;1427;149;16861;212281;195420
2024;5;Norte;Tomate;257;2396;304;14973;728144;713171
2024;7;Centro;Soja;414;1804;334;18769;602716;583947
2023;12;Norte;Manzana;463;114;244;15481;27786;12305
2024;4;Norte;Manzana;6;4875;290;18326;1414433;1396107
2024;4;Sur;Tomate;402;3903;245;4280;957835;953555
2023;4;Sur;Papa;112;3855;356;14597;1373922;1359325
2024;12;Sur;Manzana;290;3700;461;18417;1703850;1685433
2023;6;Centro;Papa;53;3302;166;3786;546712;542926
2023;7;Centro;Papa;144;388;253;3233;97993;94760
2023;2;Sur;Uva;222;3303;156;2620;516424;513804
2023;5;Centro;Papa;48;3339;350;4535;1168583;1164048
2023;4;Sur;Trigo;421;4818;392;3882;1886488;1882606
2024;3;Centro;Uva;273;3448;473;17554;1630111;1612557
2023;7;Norte;Soja;82;234;212;10745;49503;38758
2023;11;Norte;Soja;220;747;480;4897;358620;353723
2024;12;Sur;Manzana;386;245;125;16861;30701;13840
2023;6;Centro;Manzana;102;4288;341;3837;1463108;1459271
2024;7;Centro;Papa;240;721;123;9599;88575;78976
2024;5;Norte;Uva;286;1898;458;16911;868354;851443
2024;6;Norte;Uva;153;4728;312;7721;1474758;1467037
2023;5;Sur;Trigo;416;1269;368;18063;466662;448599
2023;7;Norte;Papa;308;758;433;6487;327934;321447
2023;2;Sur;Trigo;488;3996;160;16121;639840;623719
2024;11;Norte;Papa;428;3561;115;1236;411082;409846
2023;5;Norte;Maíz;70;519;452;12629;234354;221725
2023;6;Centro;Maíz;238;1833;226;12549;414203;401654
2023;6;Norte;Tomate;461;4890;152;3423;741275;737852
2024;5;Norte;Papa;91;2951;287;13906;848058;834152
2024;10;Sur;Uva;83;4242;339;15988;1439395;1423407
2023;7;Norte;Manzana;209;2144;112;2032;240964;238932
2023;10;Sur;Soja;283;1787;210;7339;375199;367860
2023;8;Norte;Tomate;341;1232;113;3940;139364;135424
2023;7;Norte;Manzana;258;3677;268;13262;985914;972652
2024;5;Sur;Maíz;308;1787;458;12652;818517;805865
2024;1;Centro;Papa;384;1314;493;5942;647881;641939
2024;5;Sur;Tomate;134;4869;355;7961;1727619;1719658
2024;10;Sur;Papa;88;711;165;8730;117073;108343
2023;2;Sur;Maíz;280;2999;462;1633;1386558;1384925
2023;5;Centro;Tomate;191;161;307;7822;49347;41525
2023;5;Norte;Maíz;50;1335;162;7487;215603;208116
2024;2;Sur;Trigo;391;1311;469;16131;614453;598322
2023;5;Sur;Maíz;187;3732;403;6738;1503959;1497221
2024;4;Centro;Uva;272;1721;393;4098;675802;671704
2024;1;Sur;Uva;300;816;384;9097;313075;303978
2023;3;Norte;Papa;326;4340;180;14136;781808;767672
2023;1;Centro;Soja;104;2732;184;6476;503781;497305
2023;12;Norte;Maíz;82;4666;375;9253;1751243;1741990
2024;11;Norte;Manzana;276;1335;188;19201;250833;231632
2023;5;Centro;Uva;343;4143;275;5887;1141272;1135385
2024;4;Sur;Soja;166;1169;413;19982;482563;462581
2023;7;Norte;Trigo;48;2879;414;12643;1190697;1178054
2024;5;Norte;Tomate;242;4526;281;10492;1273164;1262672
2024;10;Norte;Tomate;138;1252;417;3653;521934;518281
2023;4;Norte;Uva;465;357;435;2454;155456;153002
2024;2;Centro;Soja;196;1841;362;18522;666276;647754
2024;4;Centro;Uva;360;1579;191;6807;302173;295366
2023;12;Norte;Tomate;282;3945;210;4192;826872;822680
2024;2;Sur;Maíz;22;1928;226;13812;435612;421800
2023;8;Norte;Soja;16;3242;147;16775;475666;458891
2024;3;Sur;Papa;184;3768;209;11402;788492;777090
2023;9;Norte;Maíz;127;2365;184;14074;434711;420637
2023;4;Sur;Maíz;250;1407;282;16245;396957;380712
2024;6;Norte;Maíz;226;2790;463;4759;1292830;1288071
2024;10;Sur;Papa;377;1834;142;16683;260043;243360
2024;5;Norte;Trigo;55;2501;388;13460;970663;957203
2024;10;Norte;Manzana;492;4070;375;17447;1525884;1508437
2024;1;Sur;Uva;75;414;138;16460;57256;40796
2023;9;Centro;Tomate;484;1731;469;18729;811891;793162
2024;1;Sur;Uva;52;2835;327;18358;928151;909793
2023;8;Centro;Soja;23;3855;245;10814;946364;935550
2023;9;Norte;Trigo;266;4220;403;14890;1699056;1684166
2024;9;Sur;Soja;88;3202;203;2740;649846;647106
2023;1;Sur;Uva;159;74;377;12218;27928;15710
2023;2;Sur;Tomate;57;1309;116;7055;151687;144632
2023;12;Centro;Papa;111;4930;436;2954;2148297;2145343
2023;1;Centro;Uva;361;1425;279;17663;397960;380297
2024;10;Norte;Maíz;308;3603;355;19775;1277912;1258137
2023;2;Centro;Uva;139;978;189;10232;184353;174121
2024;10;Centro;Maíz;447;378;371;7439;140174;132735
2024;12;Norte;Papa;73;242;409;1961;98954;96993
2023;8;Sur;Uva;15;2252;289;18601;651481;632880
2024;5;Sur;Trigo;147;3093;347;7007;1073549;1066542
2024;12;Norte;Trigo;196;930;283;18776;262753;243977
2024;11;Sur;Soja;391;698;458;3076;319433;316357
2023;7;Centro;Papa;382;4282;299;7196;1280960;1273764
2024;2;Norte;Trigo;73;1479;437;17292;645909;628617
2024;8;Norte;Uva;27;4735;421;11315;1991257;1979942
2024;11;Norte;Papa;185;4269;264;12785;1127870;1115085
2023;6;Sur;Tomate;297;3632;192;9142;697453;688311
2024;8;Norte;Maíz;13;2110;262;7260;553727;546467
2023;1;Norte;Uva;275;2275;430;16534;979365;962831
2023;1;Norte;Maíz;391;3799;191;5841;725799;719958
2023;12;Sur;Maíz;97;833;310;14384;258038;243654
2023;7;Centro;Papa;458;3441;422;18443;1453616;1435173
2023;8;Norte;Papa;21;4161;241;2922;1004424;1001502
2023;3;Centro;Soja;158;4223;357;12991;1507104;1494113
2024;5;Sur;Maíz;409;807;198;7101;159988;152887
2023;12;Sur;Soja;332;789;144;3473;113387;109914
2024;1;Sur;Maíz;153;2860;418;9108;1194765;1185657
2024;7;Sur;Soja;381;2902;140;16450;405090;388640
2023;5;Centro;Soja;271;1903;209;11043;396871;385828
2024;8;Norte;Tomate;426;3316;442;17210;1465805;1448595
2024;8;Sur;Soja;332;2912;239;5549;694774;689225
2024;9;Sur;Papa;110;4813;489;1594;2354616;2353022
2024;7;Centro;Soja;476;3728;492;17890;1833766;1815876
2023;11;Centro;Maíz;385;31;207;5889;6427;538
2024;1;Sur;Soja;39;1510;116;9212;175749;166537
2023;3;Norte;Trigo;123;852;382;18783;325490;306707
2024;8;Norte;Manzana;18;1770;280;4201;496290;492089
2024;3;Sur;Maíz;18;3651;140;8854;512235;503381
2023;8;Centro;Trigo;270;201;383;7763;76985;69222
2024;1;Sur;Maíz;144;405;112;11653;45550;33897
2024;5;Sur;Papa;298;4672;448;6190;2093430;2087240
2024;4;Centro;Manzana;368;4336;155;14715;674075;659360
2023;5;Sur;Manzana;123;883;151;6681;133262;126581
2024;8;Sur;Papa;242;2631;170;4678;447980;443302
2023;10;Sur;Manzana;38;4345;484;15102;2103458;2088356
2024;4;Centro;Papa;173;99;377;17720;37350;19630
2023;11;Norte;Trigo;14;2289;421;2667;962639;959972
2023;4;Norte;Tomate;126;466;259;18293;120717;102424
2024;3;Centro;Maíz;405;2290;235;9204;537074;527870
2024;7;Norte;Papa;149;4459;194;6122;864110;857988
2023;3;Sur;Maíz;455;1014;292;12217;296352;284135
2023;12;Norte;Trigo;450;4544;321;16583;1457397;1440814
2024;3;Sur;Tomate;227;354;353;1973;124859;122886
2023;11;Norte;Trigo;375;2721;203;2408;551955;549547
2024;10;Centro;Manzana;261;4762;479;11135;2283189;2272054
2024;5;Norte;Maíz;272;2472;168;19672;415049;395377
2024;5;Norte;Uva;363;1126;486;9738;547529;537791
2024;6;Norte;Tomate;8;635;106;15349;67272;51923
2023;8;Centro;Manzana;430;4389;292;2218;1283563;1281345
2024;10;Norte;Tomate;401;1989;233;18804;464133;445329
2023;6;Centro;Manzana;358;4004;280;4377;1119719;1115342
2024;12;Sur;Trigo;110;1688;328;11964;554120;542156
2023;1;Norte;Papa;89;232;274;5098;63624;58526
2024;8;Centro;Maíz;218;753;266;8619;200253;191634
2023;8;Centro;Soja;125;472;393;12939;185538;172599
2023;9;Norte;Soja;136;1578;374;19226;590724;571498
2024;9;Sur;Trigo;342;3357;433;17878;1454622;1436744
2024;2;Centro;Maíz;201;1746;200;7560;349165;341605
2024;2;Norte;Maíz;23;4049;344;6510;1392087;1385577
2024;3;Sur;Trigo;134;3961;334;4444;1323291;1318847
2023;1;Centro;Maíz;16;674;248;8543;167085;158542
2024;4;Centro;Papa;85;1366;294;13429;402178;388749
2023;4;Sur;Trigo;334;1024;226;8253;230922;222669
2023;9;Sur;Papa;358;2142;157;14775;335737;320962
2024;9;Norte;Maíz;266;2678;186;1045;496823;495778
2023;9;Norte;Trigo;396;1064;142;16597;151311;134714
2023;10;Centro;Maíz;129;1774;373;3057;662110;659053
2023;7;Sur;Trigo;311;4468;364;1663;1627648;1625985
2023;2;Sur;Maíz;271;2879;480;5668;1382611;1376943
2024;10;Sur;Papa;451;1422;392;19413;557239;537826
2024;5;Centro;Uva;445;677;121;6717;81795;75078
2024;4;Sur;Papa;387;3380;454;3696;1533506;1529810
2024;12;Sur;Maíz;144;1404;445;14200;624878;610678
2023;11;Centro;Trigo;333;108;277;17101;29952;12851
2023;8;Norte;Soja;6;4080;334;9831;1364148;1354317
2024;2;Norte;Papa;12;431;490;6004;211375;205371
2024;6;Centro;Papa;254;3660;313;14156;1145287;1131131
2024;5;Sur;Manzana;143;4167;462;5402;1925696;1920294
2023;12;Centro;Soja;128;1142;133;11787;152137;140350
2024;2;Norte;Maíz;313;1712;176;15662;302031;286369
2024;11;Norte;Uva;232;3630;276;6912;1002969;996057
2024;10;Centro;Trigo;14;3200;334;1394;1068480;1067086
2023;1;Centro;Manzana;473;607;426;15635;258879;243244
2023;8;Norte;Maíz;216;401;495;4597;198615;194018
2023;2;Centro;Tomate;116;1085;256;11524;277261;265737
2023;7;Norte;Uva;12;2660;119;1329;316460;315131
2023;9;Centro;Papa;296;2394;420;18156;1006605;988449
2023;9;Centro;Tomate;481;819;342;2645;279893;277248
2023;8;Centro;Papa;366;3319;179;19171;595495;576324
2023;11;Norte;Papa;464;3748;298;10815;1116642;1105827
2024;12;Centro;Tomate;257;1169;397;18383;463999;445616
2024;10;Norte;Uva;18;1541;408;2848;628975;626127
2023;9;Norte;Tomate;244;4986;300;2561;1495052;1492491
2023;2;Centro;Maíz;442;2692;222;1773;597866;596093
2024;6;Centro;Manzana;246;263;490;8311;128739;120428
2023;4;Norte;Manzana;473;3558;365;16203;1299915;1283712
2023;4;Norte;Tomate;346;3195;263;19187;841244;822057
2023;5;Sur;Maíz;153;1241;212;10290;263328;253038
2024;12;Norte;Manzana;240;2433;392;3050;954807;951757
2024;3;Sur;Maíz;310;3585;197;18131;705779;687648
2024;1;Sur;Maíz;482;4271;169;4973;720432;715459
2024;8;Sur;Papa;171;1583;312;2615;493785;491170
2024;5;Centro;Manzana;24;2918;216;15550;630259;614709
2023;3;Centro;Manzana;220;4722;352;11494;1660066;1648572
2024;10;Norte;Papa;347;1635;147;6506;240639;234133
2023;7;Sur;Tomate;139;4008;362;14054;1450816;1436762
2023;7;Centro;Papa;397;3893;213;14861;830455;815594
2024;1;Centro;Manzana;133;3525;100;12587;352853;340266
2024;12;Centro;Manzana;414;3413;151;14515;514578;500063
2023;9;Centro;Uva;426;4608;473;6854;2181658;2174804
2023;2;Centro;Tomate;298;4690;447;17600;2096149;2078549
2023;5;Sur;Papa;250;1968;193;18743;380690;361947
2024;5;Sur;Trigo;193;4019;411;4774;1653216;1648442
2024;8;Sur;Trigo;48;2745;343;5927;942715;936788
2024;8;Sur;Tomate;90;4501;488;5429;2198108;2192679
2024;7;Norte;Papa;48;3184;249;5606;794217;788611
2024;7;Sur;Papa;334;411;373;5478;153130;147652
2023;12;Centro;Maíz;379;984;125;17076;123403;106327
2024;11;Sur;Manzana;450;233;259;19280;60231;40951
2023;6;Norte;Soja;382;4623;486;8366;2244605;2236239
2023;6;Centro;Uva;394;245;316;5427;77320;71893
2023;11;Sur;Tomate;149;3508;215;14476;754746;740270
2024;9;Sur;Soja;55;4221;148;6361;625172;618811
2024;6;Sur;Soja;246;3244;381;1641;1237294;1235653
2024;12;Centro;Tomate;298;235;358;11085;84116;73031
2023;2;Centro;Papa;412;2287;250;5050;570789;565739
2023;2;Norte;Tomate;55;4287;480;5553;2059389;2053836
2023;5;Centro;Soja;270;1351;109;19688;147097;127409
2023;4;Centro;Manzana;124;4046;221;4343;896149;891806
2023;11;Sur;Uva;204;219;468;3056;102586;99530
2023;2;Centro;Uva;409;3737;228;10416;853419;843003
2024;3;Sur;Manzana;252;3938;201;8226;791144;782918
2024;7;Sur;Manzana;74;4999;314;1886;1568136;1566250
2024;8;Centro;Papa;345;2813;430;9584;1208240;1198656
2024;12;Norte;Trigo;61;1119;141;19830;158070;138240
2023;6;Norte;Tomate;386;2036;477;12530;971600;959070
2023;11;Centro;Uva;43;403;418;4591;168466;163875
2024;5;Norte;Manzana;476;853;173;19565;147143;127578
2023;1;Sur;Tomate;293;1534;385;17738;590283;572545
2024;8;Sur;Uva;447;613;254;3631;155690;152059
2024;3;Centro;Manzana;22;591;261;18905;154204;135299
2024;6;Norte;Uva;444;1949;413;12370;805561;793191
2023;3;Norte;Papa;224;142;485;19721;68886;49165
2024;7;Sur;Trigo;317;2848;151;18012;429080;411068
2024;7;Centro;Trigo;248;3395;268;3679;910709;907030
2024;12;Norte;Manzana;356;3780;292;5422;1105196;1099774
2023;9;Centro;Uva;464;2278;251;8463;570685;562222
2023;5;Norte;Papa;308;985;245;10613;241601;230988
2024;8;Sur;Maíz;302;1823;121;18510;220419;201909
2023;10;Sur;Tomate;287;3273;374;2780;1224822;1222042
2023;10;Centro;Tomate;78;1553;274;10424;426283;415859
2023;8;Sur;Soja;114;2845;178;7571;506182;498611
2023;1;Norte;Papa;184;2748;426;1825;1171775;1169950
2023;12;Sur;Uva;430;1367;421;12155;575534;563379
2023;5;Centro;Soja;36;4144;295;3395;1220657;1217262
2023;3;Centro;Manzana;238;1326;219;5145;290898;285753
2023;1;Centro;Uva;286;171;355;16779;60746;43967
2023;4;Norte;Soja;29;1919;215;6492;413084;406592
2023;8;Norte;Trigo;335;1137;194;8111;221033;212922
2024;3;Norte;Tomate;283;3880;392;14087;1521775;1507688
2024;10;Norte;Uva;230;1668;116;10984;193705;182721
2023;2;Norte;Soja;61;3135;138;7792;432348;424556
2024;11;Sur;Trigo;184;1973;103;8711;202667;193956
2024;9;Norte;Papa;236;2299;161;2565;370553;367988
2023;10;Norte;Soja;386;976;128;4667;124538;119871
2023;5;Sur;Manzana;347;899;498;7459;447990;440531
2023;7;Norte;Manzana;481;3071;216;5096;661862;656766
2024;11;Centro;Manzana;291;3639;160;2019;581185;579166
2024;11;Norte;Uva;68;3199;196;10476;628284;617808
2023;2;Norte;Tomate;459;2758;474;9254;1308533;1299279
2023;9;Centro;Soja;236;1676;308;12584;516309;503725
2023;9;Centro;Papa;293;3076;246;6965;756481;749516
2024;4;Centro;Soja;217;1451;449;12464;652021;639557
2024;4;Centro;Tomate;262;1077;258;19653;277866;258213
2024;6;Norte;Trigo;22;4233;234;13439;990522;977083
2024;10;Centro;Tomate;179;2933;183;5721;536475;530754
2023;10;Centro;Manzana;421;4263;251;9408;1070525;1061117
2023;10;Sur;Uva;233;3866;227;1195;876306;875111
2023;6;Centro;Trigo;230;836;371;4273;310089;305816
2023;12;Centro;Uva;88;4617;216;16330;996487;980157
2024;1;Sur;Manzana;295;3995;331;11886;1321866;1309980
2024;9;Sur;Maíz;439;2102;126;4212;265609;261397
2023;2;Norte;Tomate;374;3189;177;3755;562922;559167
2023;5;Sur;Tomate;250;4548;263;18905;1195942;1177037
2024;9;Norte;Papa;406;3911;475;2080;1856865;1854785
2023;4;Sur;Soja;114;2372;251;16501;595135;578634
2024;11;Sur;Trigo;258;2234;366;18105;816817;798712
2023;3;Norte;Uva;92;1736;202;15047;350724;335677
2023;7;Sur;Trigo;76;2016;151;18946;304033;285087
2023;6;Norte;Papa;385;276;123;1639;34061;32422
2023;8;Sur;Papa;34;847;222;13502;188178;174676
2023;3;Centro;Uva;176;4594;163;6190;749098;742908
2023;5;Sur;Soja;313;4807;170;4736;815267;810531
2023;10;Norte;Uva;398;696;404;17473;281393;263920
2024;4;Sur;Uva;347;3371;106;2251;358472;356221
2024;4;Norte;Manzana;440;366;323;10294;118262;107968
2024;4;Norte;Soja;181;3825;252;17732;963059;945327
2024;10;Centro;Tomate;143;881;303;5052;266608;261556
2024;8;Centro;Manzana;198;1983;325;1271;644733;643462
2023;6;Norte;Maíz;190;4657;225;19414;1049455;1030041
2023;3;Sur;Soja;222;1820;218;12698;396833;384135
2024;10;Norte;Papa;168;4428;393;16889;1741798;1724909
2023;5;Norte;Manzana;165;2651;449;10657;1189000;1178343
2024;6;Sur;Soja;435;2238;177;10387;396193;385806
2024;5;Sur;Trigo;17;3401;139;17376;472909;455533
2023;6;Sur;Uva;300;4188;459;12279;1922795;1910516
2023;8;Sur;Maíz;93;2360;240;13015;566306;553291
2023;7;Norte;Tomate;328;4367;321;8041;1399755;1391714
2024;5;Norte;Uva;46;4889;244;18510;1192036;1173526
2023;10;Centro;Trigo;407;2749;150;9708;413230;403522
2024;6;Norte;Trigo;214;2740;336;11857;919900;908043
2024;4;Sur;Maíz;233;1328;310;10493;411760;401267
2024;12;Centro;Tomate;354;1545;181;9052;279954;270902
2023;9;Sur;Papa;279;4794;281;17995;1345916;1327921
2023;4;Norte;Manzana;446;2453;419;18133;1027267;1009134
2024;1;Centro;Tomate;283;1782;336;14580;599055;584475
2023;7;Sur;Soja;255;3219;139;19240;446701;427461
2023;7;Centro;Trigo;314;4944;319;18910;1578174;1559264
2023;4;Centro;Soja;212;887;381;11216;338036;326820
2024;3;Norte;Papa;325;2880;417;7229;1201190;1193961
2024;8;Sur;Soja;144;3210;352;14343;1128797;1114454
2023;5;Centro;Tomate;284;4154;161;3098;669043;665945
2024;10;Centro;Soja;38;3757;384;16438;1442951;1426513
2023;7;Sur;Papa;313;2846;371;8865;1055695;1046830
2023;4;Centro;Papa;396;302;110;17557;33151;15594
2023;4;Centro;Papa;22;1661;265;13211;439667;426456
2023;8;Centro;Tomate;61;4641;233;1500;1082188;1080688
2024;8;Sur;Papa;116;4416;368;4646;1624028;1619382
2024;2;Sur;Trigo;9;546;186;19747;101802;82055
2024;2;Sur;Uva;414;2696;336;11048;906800;895752
2023;3;Sur;Papa;418;243;465;12344;113063;100719
2023;12;Norte;Soja;186;2662;419;19280;1115697;1096417
2023;12;Centro;Manzana;17;2384;469;10910;1117095;1106185
2024;3;Sur;Soja;343;2282;491;2778;1121375;1118597
2023;1;Centro;Manzana;289;976;104;13984;101768;87784
2024;3;Centro;Soja;263;899;349;6190;313841;307651
2024;6;Norte;Tomate;94;3873;265;16304;1026887;1010583
2024;8;Sur;Soja;108;3410;444;7997;1513835;1505838
2024;12;Sur;Tomate;383;44;201;13020;8832;-4188
2024;10;Centro;Tomate;190;4552;492;5747;2241450;2235703
2024;6;Sur;Papa;254;3533;345;10286;1220581;1210295
2023;5;Centro;Trigo;259;1773;417;1045;740068;739023
2023;4;Centro;Manzana;80;3301;134;8758;443126;434368
2024;3;Norte;Papa;390;2498;173;1455;433103;431648
2024;4;Norte;Papa;463;2710;403;10854;1093106;1082252
2023;7;Norte;Uva;112;1568;109;18349;170583;152234
2024;1;Centro;Tomate;160;4700;427;2528;2005725;2003197
2024;7;Sur;Tomate;86;2286;106;3976;241356;237380
2023;1;Norte;Manzana;81;4016;363;14288;1457206;1442918
2024;2;Sur;Soja;489;4449;246;7387;1094632;1087245
2024;4;Norte;Soja;474;1113;345;3521;383540;380019
2024;1;Norte;Papa;464;1429;378;7525;540748;533223
2023;11;Centro;Maíz;262;1488;237;2126;352641;350515
2023;12;Norte;Maíz;131;3924;143;14348;561838;547490
2023;11;Norte;Soja;489;3752;128;8716;479731;471015
2024;11;Centro;Maíz;395;2966;336;17102;995301;978199
2024;9;Sur;Uva;286;1392;308;4404;429098;424694
2023;12;Norte;Soja;478;2584;397;5492;1025538;1020046
2024;6;Centro;Tomate;92;3394;304;3343;1031403;1028060
2024;1;Norte;Papa;208;1579;269;1106;424719;423613
2024;1;Centro;Trigo;20;1904;259;16195;493574;477379
2024;6;Sur;Papa;155;2253;111;14241;249137;234896
2024;4;Sur;Soja;428;1876;234;13575;439397;425822
2023;4;Centro;Uva;258;38;490;5801;18636;12835
2024;11;Centro;Soja;192;715;449;6580;321335;314755
2023;6;Centro;Papa;333;1030;232;17598;238703;221105
2024;12;Sur;Uva;36;2073;335;6400;694704;688304
2023;11;Norte;Uva;275;1456;439;7875;639068;631193
2024;7;Sur;Uva;489;3674;277;9656;1015898;1006242
2023;9;Centro;Manzana;401;2997;107;7247;321218;313971
2024;10;Centro;Soja;9;3612;130;7177;468838;461661
2023;5;Sur;Maíz;463;3695;304;8269;1123871;1115602
2024;9;Centro;Maíz;334;3378;488;15974;1647721;1631747
2023;4;Sur;Soja;312;3591;377;15037;1354812;1339775
2024;10;Centro;Soja;337;2772;128;19756;355842;336086
2023;2;Norte;Manzana;173;4047;176;17167;711220;694053
2023;3;Norte;Maíz;185;582;409;11380;237764;226384
2024;11;Centro;Soja;370;4098;437;7617;1789105;1781488
2024;1;Sur;Soja;182;624;347;1303;216578;215275
2023;6;Norte;Manzana;147;4060;358;13683;1452546;1438863
2024;6;Sur;Manzana;366;335;111;17717;37296;19579
2023;1;Centro;Papa;252;3750;431;12025;1617788;1605763
2023;11;Sur;Manzana;131;368;415;19715;152834;133119
2023;3;Norte;Trigo;267;3787;204;5561;771071;765510
2024;5;Sur;Maíz;44;2381;383;1079;913042;911963
2023;3;Sur;Papa;416;1731;186;4763;321862;317099
2023;10;Centro;Trigo;420;1359;116;11169;157821;146652
2024;3;Centro;Soja;359;3706;180;18116;668748;650632
2024;10;Centro;Soja;259;3906;171;4976;669684;664708
2024;3;Norte;Papa;147;4270;235;18768;1003877;985109
2024;5;Norte;Manzana;244;1606;267;3124;429412;426288
2023;5;Centro;Uva;232;1637;303;7652;496699;489047
2023;4;Centro;Uva;345;2512;291;6283;730238;723955
2023;1;Norte;Soja;202;3818;208;8176;795175;786999
2023;5;Norte;Uva;69;202;112;19676;22557;2881
2024;10;Norte;Tomate;392;2684;342;13409;918035;904626
2023;5;Norte;Papa;15;3855;258;13319;995747;982428
2023;4;Centro;Trigo;112;2587;219;1997;567769;565772
2024;6;Norte;Papa;30;101;447;12001;45125;33124
2023;10;Centro;Maíz;449;4244;399;5664;1692083;1686419
2023;4;Sur;Manzana;425;490;443;19741;217124;197383
2023;7;Sur;Manzana;155;2926;298;19063;871919;852856
2023;7;Norte;Papa;225;4445;152;14117;677285;663168
2023;2;Sur;Soja;345;1085;378;12231;410662;398431
2023;3;Sur;Soja;241;2523;182;8440;460271;451831
2024;1;Sur;Tomate;241;808;276;12218;223404;211186
2024;8;Norte;Tomate;223;4580;126;16608;577080;560472
2023;9;Norte;Manzana;491;3959;430;5090;1702845;1697755
2023;4;Sur;Tomate;428;614;150;8471;92333;83862
2024;6;Centro;Trigo;465;2989;461;4743;1378646;1373903
2023;9;Sur;Tomate;155;4926;446;11196;2195469;2184273
2023;6;Norte;Trigo;127;607;286;8008;173499;165491
2023;12;Norte;Tomate;148;1542;398;4324;613331;609007
2024;12;Norte;Manzana;482;523;348;9632;181889;172257
2023;12;Sur;Manzana;193;1887;421;1226;794861;793635
2024;9;Centro;Trigo;259;3982;273;15863;1085971;1070108
2023;4;Norte;Papa;72;3853;414;17027;1596375;1579348
2024;8;Norte;Manzana;108;1709;285;19785;487031;467246
2024;9;Sur;Papa;340;1039;476;5718;494969;489251
2023;4;Centro;Soja;163;4605;295;18408;1356403;1337995
2024;5;Sur;Trigo;313;726;285;6672;206946;200274
2023;8;Norte;Uva;366;4096;414;16262;1695867;1679605
2024;12;Centro;Manzana;413;675;429;18254;289325;271071
2023;10;Centro;Maíz;304;2218;322;4199;713752;709553
2023;6;Norte;Soja;400;1089;172;19129;187221;168092
2024;12;Centro;Papa;94;237;287;6270;68043;61773
2023;7;Centro;Manzana;361;158;487;13750;76982;63232
2023;3;Sur;Trigo;260;1079;401;8897;432884;423987
2024;7;Norte;Uva;357;4737;424;9664;2010714;2001050
2023;12;Norte;Tomate;224;1373;113;15892;155327;139435
2023;8;Norte;Uva;13;4518;287;9271;1297299;1288028
2024;10;Norte;Maíz;16;1765;359;6158;633017;626859
2024;6;Norte;Papa;329;529;432;13844;228533;214689
2023;10;Centro;Soja;442;3554;120;1589;425449;423860
2023;9;Sur;Uva;248;2332;441;10552;1028365;1017813
2024;6;Norte;Trigo;186;1112;319;17267;355128;337861
2024;12;Sur;Maíz;288;607;179;19268;108611;89343
2023;9;Sur;Trigo;316;3283;227;17159;744913;727754
2024;4;Centro;Manzana;103;4059;213;15263;863633;848370
2023;8;Norte;Tomate;201;2615;312;6399;816769;810370
2023;11;Centro;Soja;486;2198;121;9503;265233;255730
2023;4;Norte;Trigo;370;4835;163;2076;790087;788011
2023;2;Centro;Papa;230;598;425;8235;254198;245963
2023;10;Sur;Manzana;337;4482;153;17417;685925;668508
2024;11;Norte;Manzana;107;1417;193;2841;273991;271150
2024;9;Sur;Soja;110;4856;281;5481;1366236;1360755
2024;5;Sur;Manzana;369;4732;307;2134;1452014;1449880
2024;4;Centro;Papa;372;3400;405;14139;1378496;1364357
2023;2;Norte;Trigo;62;3450;279;8771;962309;953538
2023;1;Sur;Soja;82;1639;416;9567;681742;672175
2023;11;Centro;Manzana;79;1004;347;9915;348729;338814
2023;7;Norte;Manzana;46;4808;145;14898;698314;683416
2024;6;Norte;Papa;426;2069;163;2913;336275;333362
2023;2;Sur;Tomate;328;4582;275;5297;1259179;1253882
2023;8;Norte;Tomate;185;2996;259;2942;775245;772303
2024;11;Sur;Uva;37;410;397;18715;162942;144227
2024;4;Norte;Manzana;75;2865;332;1337;952011;950674
2024;8;Centro;Trigo;60;2234;255;15256;570229;554973
2024;7;Sur;Soja;109;3422;168;11057;575923;564866
2023;5;Sur;Manzana;204;66;191;9983;12588;2605
2023;10;Norte;Maíz;105;1885;330;17283;622427;605144
2024;10;Norte;Soja;260;4553;269;4700;1226487;1221787
2023;12;Sur;Uva;311;4308;306;13145;1318119;1304974
2023;8;Norte;Tomate;78;3778;168;7118;635724;628606
2023;9;Centro;Manzana;175;4843;365;3673;1768470;1764797
2024;5;Norte;Papa;381;4307;441;3122;1899473;1896351
2023;10;Centro;Maíz;147;1363;203;12977;276934;263957
2024;5;Centro;Manzana;170;2420;297;9250;717796;708546
2023;2;Centro;Uva;403;4997;490;19446;2449579;2430133
2023;5;Centro;Trigo;265;4321;233;18638;1008089;989451
2023;3;Centro;Maíz;225;2612;338;4688;882908;878220
2024;7;Norte;Uva;87;2944;136;4748;400620;395872
2023;10;Centro;Manzana;186;32;342;7342;10957;3615
2024;5;Norte;Trigo;311;2212;136;17275;300500;283225
2024;8;Centro;Maíz;14;1219;484;14665;589618;574953
2024;1;Sur;Trigo;400;2306;386;5130;890739;885609
2023;3;Centro;Trigo;8;758;415;4029;314767;310738
2023;3;Sur;Maíz;355;814;382;14182;310655;296473
2023;9;Centro;Maíz;406;143;336;5035;48032;42997
2023;5;Centro;Trigo;340;4426;280;16127;1239147;1223020
2024;12;Centro;Uva;492;2447;443;3899;1084877;1080978
2024;9;Sur;Tomate;296;443;483;10638;213849;203211
2024;9;Sur;Maíz;285;4978;300;14222;1491459;1477237
2023;1;Centro;Manzana;219;3681;473;18296;1739677;1721381
2024;2;Norte;Soja;464;3746;333;5242;1248654;1243412
2023;5;Centro;Papa;102;4049;315;19095;1276852;1257757
2024;4;Sur;Trigo;424;2108;282;2439;594013;591574
2023;10;Centro;Trigo;105;2927;184;6613;537748;531135
2023;9;Sur;Papa;455;262;101;6375;26590;20215
2024;7;Sur;Tomate;13;4844;197;9877;952330;942453
2024;6;Sur;Papa;65;1139;304;3466;346131;342665
2024;7;Centro;Maíz;313;3274;252;8824;824983;816159
2024;1;Sur;Papa;150;311;279;13329;86890;73561
2023;1;Sur;Trigo;431;1987;492;12630;978121;965491
2024;8;Centro;Papa;423;2773;240;18349;665825;647476
2024;2;Sur;Soja;67;4015;281;15203;1127693;1112490
2024;12;Centro;Manzana;125;3251;153;7928;498736;490808
2023;10;Sur;Maíz;230;3067;119;10111;365525;355414
2023;11;Norte;Papa;109;560;410;9120;229690;220570
2024;9;Norte;Trigo;466;1597;328;12064;524247;512183
2023;7;Sur;Uva;264;1832;404;18892;740641;721749
2024;6;Norte;Manzana;353;3227;160;10404;516159;505755
2023;1;Centro;Maíz;429;3506;329;1871;1152527;1150656
2023;1;Norte;Trigo;259;4419;201;13582;890252;876670
2023;2;Sur;Tomate;433;4289;191;1863;820143;818280
2023;6;Sur;Soja;438;722;105;15883;75528;59645
2024;6;Centro;Tomate;211;2185;152;13145;332426;319281
2024;2;Sur;Soja;32;4082;224;4055;913184;909129
2024;1;Centro;Papa;174;3859;147;13186;566308;553122
2023;10;Norte;Maíz;340;2443;494;3682;1207673;1203991
2024;5;Norte;Papa;80;3311;223;13882;739843;725961
2024;5;Centro;Soja;120;280;152;6278;42596;36318
2024;2;Centro;Soja;73;1804;180;14805;324053;309248
2023;6;Sur;Soja;358;4916;335;17997;1647253;1629256
2023;9;Norte;Manzana;238;2472;126;2872;310533;307661
2023;2;Centro;Trigo;5;4303;445;12346;1914706;1902360
2024;10;Norte;Maíz;171;3404;485;8723;1649578;1640855
2024;2;Centro;Papa;356;1089;199;14871;216384;201513
2024;3;Norte;Papa;222;2888;280;16946;808756;791810
2023;7;Sur;Tomate;277;4733;109;8189;515187;506998
2023;6;Norte;Soja;372;613;356;13752;218400;204648
2024;12;Norte;Uva;255;1595;266;12565;423584;411019
2023;8;Norte;Soja;351;3067;208;7942;637997;630055
2023;8;Norte;Soja;348;3995;183;15730;730006;714276
2023;6;Norte;Uva;423;4699;362;12383;1699205;1686822
2023;12;Sur;Papa;178;1405;266;1244;374418;373174
2024;11;Centro;Tomate;174;3698;172;1020;635538;634518
2023;10;Norte;Trigo;250;609;376;14917;228765;213848
2023;3;Sur;Uva;427;523;326;14721;170514;155793
2023;3;Norte;Manzana;94;1076;443;6767;477174;470407
2023;1;Norte;Maíz;53;2896;147;11247;425683;414436
2024;7;Centro;Uva;450;2663;414;4515;1103201;1098686
2024;5;Norte;Trigo;298;4915;369;2910;1815650;1812740
2023;4;Sur;Papa;411;1098;146;11750;160308;148558
2023;10;Sur;Manzana;154;4395;378;9076;1661002;1651926
2023;4;Centro;Manzana;136;4874;277;19006;1348246;1329240
2023;4;Norte;Manzana;437;2524;478;16051;1206447;1190396
2023;6;Sur;Soja;63;3979;157;5314;623271;617957
2023;8;Norte;Maíz;461;3294;357;3453;1176386;1172933
2024;8;Norte;Papa;328;4576;253;3015;1156767;1153752
2023;5;Norte;Papa;203;2206;483;11236;1064902;1053666
2024;6;Centro;Manzana;219;4193;232;3800;972734;968934
2024;4;Norte;Papa;390;799;485;10023;387411;377388
2023;12;Sur;Maíz;53;3485;461;12884;1605156;1592272
2024;11;Norte;Maíz;476;3163;208;17352;658378;641026
2024;9;Sur;Tomate;236;1674;421;13882;705457;691575
2024;8;Norte;Uva;251;1319;498;11346;657179;645833
2024;10;Sur;Uva;386;874;201;15035;175735;160700
2024;12;Sur;Tomate;483;3873;275;17108;1063952;1046844
2024;10;Norte;Trigo;243;3373;308;3853;1039120;1035267
2023;1;Norte;Uva;419;3534;218;19620;770306;750686
2024;2;Sur;Maíz;371;3796;106;5176;402794;397618
2024;9;Centro;Maíz;172;33;188;3155;6206;3051
2024;8;Norte;Uva;52;3013;213;7829;641076;633247
2023;3;Centro;Maíz;55;320;277;2886;88781;85895
2024;8;Norte;Tomate;303;1241;168;7471;209034;201563
2023;12;Norte;Manzana;102;3798;449;13589;1706441;1692852
2024;1;Norte;Manzana;443;2721;382;9391;1039313;1029922
2023;10;Norte;Papa;220;4811;134;14350;645059;630709
2023;4;Centro;Manzana;181;431;360;8899;155177;146278
2024;3;Norte;Soja;384;1783;361;1306;644483;643177
2024;6;Sur;Tomate;478;3578;482;4075;1726349;1722274
2023;7;Sur;Maíz;84;956;101;19040;96757;77717
2024;4;Centro;Uva;189;1196;199;8244;238207;229963
2023;7;Norte;Manzana;371;1844;471;7611;868745;861134
2023;9;Sur;Tomate;465;1574;473;15134;744266;729132
